#level1
一	yiaa
上	uhaa
中	vsaa
里	liaa
而	eraa
面	mmaa
事	uiaa
十	uiaa
本	bfaa
再	zdaa
口	kzaa
与	yuaa
二	eraa
西	xiaa
由	yzaa
非	fwaa
五	wuaa
且	qpaa
工	gsaa
止	viaa
耳	eraa
野	yeaa
丁	dkaa
互	huaa
甲	jxaa
曲	quaa
井	jkaa
申	ufaa
巾	jbaa
串	iraa
凸	tuaa
凹	waaa
凹	aoaa
亘	gfaa
廿	nmaa
亙	gfaa
亜	yaaa
車	juaa
車	ieaa
円	yraa
冊	ceaa
門	mfaa
門	mfaa
頃	qkaa
頓	dyaa
鯉	liaa
鱗	lbaa
百	bdab
典	dmab
頼	ldab
耐	ndac
鮒	fuac
専	vrac
鱒	zyac
不	buad
下	xxad
天	tmad
小	xnad
内	nwad
求	qqad
雨	yuad
瓦	waad
虫	isad
寸	cyad
甫	fuad
卜	buad
卜	boad
豊	fgad
弐	erad
三	sjae
児	erae
鱈	xtae
雅	yaaf
鮫	jnaf
弼	biag
馬	maah
鰍	qqah
融	rsai
蚕	cjai
規	gvaj
帰	gvaj
石	uiak
石	djak
否	fzak
占	vjak
画	hxak
両	llak
鮎	nmak
鯛	dnak
勅	cial
勅	iial
麗	lial
来	ldan
大	daan
大	ddan
果	goan
水	uvan
更	ggan
夫	fuan
未	wwan
木	muan
史	uian
束	uuan
丈	vhan
妻	qian
央	yhan
末	moan
夷	yian
吏	lian
丙	bkan
農	nsan
長	vhan
長	ihan
婁	lzan
鹸	jman
東	dsan
業	yean
旧	jqao
曹	ccao
晋	jbao
魯	luao
鮪	wwao
鯖	qkao
鰭	qiao
才	cdap
万	wjap
形	xkap
牙	yaap
曳	yeap
暢	ihap
豆	dzaq
肉	rzar
里	liat
王	what
鮭	xpat
鮭	gvat
鰹	jmat
平	pkau
干	gjau
卓	voau
乾	qmau
乾	gjau
正	vgav
比	biav
整	vgav
北	bwav
七	qiav
歪	wdav
屯	vyav
屯	tyav
髭	ziav
糸	miav
糸	siav
夏	xxaw
璽	xiaw
鯨	jkax
爾	erax
叔	uuay
叢	csay
鮮	xmay
鰻	mjay
半	bjba
痛	tsba
写	xpba
宣	xrba
皆	jpba
羊	yhba
宙	vzba
窄	vdba
貞	vfba
貴	gvba
賛	zjba
購	gzba
頁	yeba
頒	bjba
額	eeba
穴	xtbb
冥	mkbb
宿	xqbb
宿	subb
寅	ybbb
貧	pbbb
賓	bbbb
守	uzbc
冠	grbc
痔	vibc
貰	uibc
的	debd
的	dibd
分	ffbd
寒	hjbd
泉	qrbd
窃	qpbd
寡	gxbd
券	xrbd
券	qrbd
寓	yubd
痢	libd
負	fubd
貯	vubd
資	zibd
賦	fubd
寧	nkbd
完	wjbe
密	mibe
癌	aibe
責	zebf
空	ksbg
貢	gsbg
窮	qsbg
窯	ycbh
蜜	mibi
軍	jybi
究	jqbj
冗	rsbj
質	vibj
寛	krbj
窺	kvbj
容	rsbk
害	hdbk
官	grbk
客	kebk
谷	gubk
痴	iibk
寄	jibk
窟	kubk
貼	tpbk
賂	lubk
賠	pwbk
賢	xmbk
員	yrbk
宮	gsbk
賀	hebl
寵	isbl
米	mibm
案	anbm
宋	ssbm
家	jxbn
安	anbn
病	bkbn
痕	hfbn
牢	lcbn
宴	yjbn
賑	vfbn
実	uibn
曾	zgbo
曾	cgbo
宵	xnbo
宥	yzbo
賄	hvbo
賭	dubo
贈	zgbo
曽	cgbo
曽	zgbo
弟	dibp
穿	irbp
疲	pibp
疹	vfbp
財	cdbp
貿	mcbp
賜	cibp
突	tubq
欲	yubq
宜	yibq
宅	vdbq
痘	dzbq
定	dkbr
貨	hobr
貸	ddbr
賃	lbbr
公	gsbs
宏	hsbs
買	mdbs
富	fubt
塞	sebt
塞	sdbt
窒	vibt
審	ufbt
宇	yubu
拳	qrbu
疾	jibu
宰	zdbu
癖	pibu
宕	dhbu
賊	zwbu
宛	yrbv
宛	wjbv
症	vgbv
貫	grbv
費	fwbv
巻	jrbv
捲	jrbv
宝	bcbw
皇	hlbw
甑	zgbw
父	fubx
察	iabx
宗	zsbx
寮	lnbx
賞	uhbx
憲	xmbx
療	lnbx
癒	yubx
寂	jiby
叛	pjby
翁	wgby
寝	qbby
疫	yiby
謄	tgby
販	fjby
痩	uzby
字	zibz
甘	gjca
董	dsca
革	geca
萱	xrca
芥	jpca
苧	vuca
苧	nkca
華	hxca
葎	lvca
葦	wwca
蔵	chca
蔵	zhca
黄	hlcb
共	gscb
薄	bocc
薄	bccc
蒋	jlcc
葬	zhcc
蔚	wwcc
蒔	uicc
莫	mocd
藤	tgcd
蔑	mpcd
蒲	pucd
葡	pucd
葵	kvcd
菟	tucd
苧	vucd
苧	nkcd
荊	jkcd
夢	mgcd
莞	wjce
莞	grce
茸	rsce
葺	qice
蔀	buce
芳	fhcf
萄	tccf
薩	sacf
難	njcf
芸	yycg
芸	yicg
茎	jkcg
菰	gucg
蒐	szcg
蒐	szcg
芦	luch
蒸	vgch
菌	jych
蕉	jnch
荻	dich
萩	qqch
蕪	wuch
薦	jmch
薫	xych
蘇	such
繭	jmci
幕	mucj
薪	xbcj
芹	qbcj
落	lock
落	lcck
落	lack
若	rock
苦	kuck
荷	heck
蓉	rsck
菩	puck
茄	qpck
茄	jxck
苛	keck
苔	tdck
菅	jmck
苫	ujck
蒼	chck
蕎	qnck
蕗	luck
勤	qbcl
募	mucl
某	mzcm
茶	iacm
菜	cdcm
菊	jucm
藻	zccm
藁	gccm
葉	yecm
葉	xpcm
蓋	gdcm
薬	yccm
藍	ljcm
驚	jkcm
英	ykcn
蒙	mgcn
莱	ldcn
芙	fucn
芝	vicn
萎	wwcn
蔦	nncn
蘭	ljcn
著	vuco
著	voco
著	veco
著	vcco
昔	xico
暮	muco
萌	mgco
薯	uuco
菖	ihco
藷	uuco
藷	vuco
茅	mccp
茂	mccp
芽	yacp
蕩	dhcp
蕨	jtcq
歎	tjcq
茨	cicr
芸	yycs
芸	yics
苓	lkcs
蒐	szcs
蔭	ybcs
墓	muct
苗	mnct
蓄	xuct
藩	fjct
蕃	fjct
蕃	boct
草	cccu
芋	yucu
荏	rfcu
荘	vlcu
世	uicv
花	hxcv
荒	hlcv
葛	gecv
巷	xlcv
巷	hhcv
苑	yrcv
芭	bacv
導	dccv
蔽	bicw
菱	lkcw
薮	szcw
慕	mucx
恭	gscx
惹	recx
茜	xicx
茜	qmcx
蕊	rvcx
弊	bicx
葱	cscx
芯	xbcx
蒜	srcx
蔓	wjcy
蔓	mjcy
蓑	socy
蓬	pgcz
蓮	lmcz
到	dcda
争	vgda
角	jnda
角	jtda
副	fuda
刺	cida
州	vzda
油	yzda
涌	ysda
洲	vzda
刑	xkda
湿	uida
津	jbda
刊	kjda
沸	fwda
濡	ruda
頂	dkda
沖	isda
浄	jkda
淵	yrda
済	jida
溝	gzda
滅	mpda
漁	yuda
瀕	bbda
瀬	ldda
演	yjdb
判	pjdb
洪	hsdb
割	gedb
泊	bodb
剃	tidb
浜	bhdb
浜	bbdb
則	zedb
頭	tzdb
漬	zidb
潰	kvdb
将	jldc
奔	bfdc
涛	tcdc
奪	dodc
対	dvdc
心	xbdd
太	tddd
海	hddd
列	lpdd
漠	modd
刃	rfdd
漏	lzdd
漆	qidd
沃	wodd
犬	qrdd
澄	igdd
澄	dgdd
浦	pudd
汰	tddd
溺	nndd
溺	nidd
汀	tkdd
汐	xidd
凍	dsdd
剣	jmdd
奨	jldd
汎	fjdd
涙	lwdd
渋	sedd
測	cedd
湊	czdd
洗	xide
剥	bode
剥	bcde
況	klde
准	vydf
契	xpdf
契	qidf
淘	tcdf
濯	vodf
灘	tjdf
江	jldg
残	cjdg
滑	hxdg
浅	qmdg
湾	wjdg
戦	vjdg
利	lidh
淡	djdh
劇	judh
魚	yudh
為	wwdh
濁	vodi
滞	vidj
漸	jmdj
可	kedk
奇	qidk
奇	jidk
活	hodk
治	vidk
河	hedk
洞	dsdk
洛	lodk
浩	hcdk
召	vcdk
召	ucdk
沿	yjdk
滴	didk
浴	yudk
冶	yedk
沼	vcdk
溶	rsdk
殆	dddk
凋	dndk
別	bpdk
剛	ghdk
減	jmdk
渦	wodk
渦	godk
満	mjdk
勉	mmdl
泣	qidl
剖	pzdl
漉	ludl
湧	ysdl
瀧	uldl
瀧	lsdl
深	ufdm
温	wfdm
淋	lbdm
溢	yidm
濫	ljdm
之	vidn
象	xldn
派	pddn
永	ysdn
良	lldn
浪	lhdn
殊	uudn
液	yedn
凄	qidn
汝	rudn
沫	modn
泳	ysdn
汲	jidn
濠	hcdn
鴻	hsdn
巣	ccdn
巣	icdn
決	jtdn
沢	zedn
渓	xidn
漢	hjdn
濃	nsdn
清	qkdo
消	xndo
湖	hudo
潜	qmdo
朗	lhdo
潮	icdo
湘	xldo
脊	jido
殉	xydo
沓	tado
沓	dado
漕	ccdo
渚	vudo
澗	jmdo
瀦	vudo
制	vidp
必	bidp
波	bodp
沙	uadp
泌	midp
泌	bidp
剰	ugdp
劉	lqdp
洩	xpdp
渉	uedp
湯	thdp
状	vldq
歌	gedq
汽	qidq
殖	vidq
次	cidr
火	hodr
凝	nkdr
欠	qmdr
欠	qtdr
淀	dmdr
創	ildr
法	fads
冷	lgds
套	tcds
滋	zids
潔	jpds
溜	lqdt
涯	yadt
渥	wodt
奮	ffdt
浬	lidt
窪	wadt
斗	dzdu
汗	hjdu
壮	vldu
淫	ybdu
刷	uxdu
汁	vidu
色	sedv
色	uddv
死	sidv
流	lqdv
免	mmdv
危	wwdv
混	hydv
沈	ufdv
登	dgdv
港	ghdv
池	iidv
泥	nidv
泡	pcdv
湛	vjdv
沌	dydv
奄	yjdv
劃	hxdv
氾	fjdv
氾	fjdv
渇	kedv
滝	lsdv
滝	uldv
主	vudw
刻	kedw
注	vudw
凌	lkdw
激	jidw
班	bjdw
剤	jidw
潤	rydw
源	yrdx
奈	nddx
漂	pndx
爽	uldx
添	tmdx
削	xtdx
削	xndx
刈	yidx
涼	lldx
没	mwdy
没	mody
酒	jqdy
洋	yhdy
漫	mjdy
渡	dudy
淑	uudy
浸	jbdy
澱	dmdy
浮	fudz
淳	vydz
淳	iydz
漣	lmdz
邪	yeea
邪	xpea
降	xlea
降	jlea
隔	geea
岬	jxea
聯	lmea
頑	wjea
嶺	lkea
階	jpeb
附	fuec
尋	xyec
郎	lhed
峨	eeed
隅	yued
陳	ifed
元	yree
院	yree
耶	yeee
防	fhef
峰	fgef
隆	lsef
邦	bhef
陶	tcef
峯	fgef
嵐	ljef
魂	hyeg
嵯	coeg
職	vieg
除	iueh
炭	tjeh
陣	vfei
凱	kdej
出	iuek
阿	aaek
阿	eeek
陪	pwek
叩	kzek
嵩	ssek
崎	qiek
部	buel
限	xmen
峡	xxen
隈	wwen
険	xmen
隊	dven
崩	bgeo
陥	xmeo
印	ybep
兜	dzep
祁	qiep
邸	diep
卯	mcep
郵	yzep
陽	yhep
阻	zueq
鄭	vgeq
岨	jueq
卸	xper
岱	dder
云	yyes
陰	ybes
都	dzet
都	duet
崖	yaet
陛	biet
陸	luet
陸	lqet
却	qteu
岸	aneu
岩	yjeu
郁	yueu
障	vheu
那	naev
些	xpev
即	jiev
幽	yzev
郡	jyev
陀	toev
耽	djev
郷	xlev
郭	goew
陵	lkew
峻	jyew
郊	jnew
巌	yjew
示	uiex
崇	isex
隙	xiex
聴	tkex
際	jiex
隠	ybex
恥	iiex
取	quey
岐	qiey
阪	bjey
随	svez
静	jkfa
担	djfa
排	pdfa
抽	izfa
撞	vlfa
拒	jufa
奉	fgfa
捧	pgfa
押	yafa
釜	fufa
麺	mmfa
挿	iafa
搾	vafa
拍	pdfb
旗	qifb
撰	vrfb
摺	vefb
摺	uefb
損	syfb
持	iifc
寿	uzfc
打	dafd
毒	dufd
摸	mofd
挑	tnfd
抵	difd
泰	tdfd
扮	bjfd
捕	bufd
奏	zzfd
於	wufd
於	yufd
拭	uifd
捌	bafd
拶	zjfd
拶	zafd
掛	gxfd
摂	uefd
摂	npfd
撲	pufd
抑	yife
揖	yife
爺	yefe
推	tvff
擢	voff
缶	fzff
缶	grff
拝	pdff
拝	bdff
揺	ycff
擁	ysff
控	ksfg
拷	kcfg
秦	qbfh
撚	nmfh
撫	fufh
掻	scfi
揮	hvfi
抗	khfj
折	vefj
折	uefj
斧	fufj
摺	vefj
摺	uefj
帯	dffj
拠	jufj
掃	scfj
撹	jnfj
招	vcfk
据	jufk
括	kofk
拾	uifk
搭	dafk
拓	tofk
拓	tafk
摘	vdfk
拘	jufk
掘	jtfk
拙	vofk
捨	uefk
拐	gkfl
探	tjfm
操	ccfm
掬	jufm
麹	qufm
採	cdfm
接	jpfn
按	anfn
扶	fufn
振	vffn
旅	lvfn
抹	mofn
抹	mafn
欠	qmfn
欠	qtfn
挟	xpfn
挟	jxfn
扱	xifn
択	zefn
択	vdfn
換	hrfn
指	vifo
青	qkfo
春	iyfo
措	cofo
披	pifp
携	xpfp
抄	icfp
揚	yhfp
托	tofq
提	tifr
提	difr
旋	xrfr
捷	jpfr
擬	nifr
素	sufs
払	fufs
拡	klfs
拡	kofs
握	woft
描	mnft
播	boft
挫	coft
族	zufu
挨	aifu
把	bafv
施	uifv
抱	bcfv
批	pifv
掩	yjfv
挽	wjfv
捲	jrfv
掲	qpfv
掲	qifv
掲	jpfv
撒	safw
麦	mdfw
撤	iefw
掴	gofw
擾	rcfw
掠	ltfx
擦	cafx
捺	nafx
捻	nmfx
表	bnfy
技	jify
投	tzfy
援	yrfy
授	uzfy
搬	bjfy
撮	zofy
撮	cofy
抜	bofy
抜	bafy
捜	szfy
挺	tkfz
捉	vofz
或	hoga
引	ybga
羽	yuga
序	xuga
庸	ysga
項	xlga
弔	dnga
弾	tjga
彊	jlga
府	fugc
戒	jpgc
底	digd
弱	rogd
丸	wjgd
勺	ucgd
庁	tkgd
廊	lhge
廓	koge
耀	ycgf
雛	iugf
魔	mogg
巧	qngg
乙	yigg
弧	hugg
庶	uugh
輝	hvgi
庫	kugi
強	qlgi
強	jlgi
席	xigj
司	sigk
句	jugk
句	gzgk
唐	thgk
店	dmgk
功	gsgl
麻	magm
床	ilgm
鞠	jugm
威	wwgn
康	khgn
鞭	bmgn
魅	mwgn
廉	lmgn
鞍	angn
庚	gggn
鷹	ykgn
張	vhgn
鞘	ucgo
鞘	qngo
旬	xygo
廟	mngo
力	ligp
刀	dcgp
乃	ndgp
勿	wugp
戊	wugp
腐	fugr
骸	hdgr
勾	gzgs
弘	hsgs
弦	xmgs
広	glgs
座	zogt
庄	vlgt
摩	mogu
磨	mogu
魁	kvgu
戎	rsgu
成	iggv
包	bcgv
鹿	lugv
靴	xtgv
庇	bigv
弛	iigv
庵	angv
庖	pcgv
廃	fwgv
慶	qkgw
弥	migx
戚	qigx
応	ykgx
度	dugy
度	dogy
庭	tkgz
髄	svgz
点	dmha
虚	xuha
虐	ntha
扉	fwha
肇	vcha
顧	guha
黙	moha
煩	fjha
種	vsha
種	isha
積	jihb
燕	yjhc
烈	lphd
移	yihd
灯	dghd
爆	bchd
灼	vohd
虞	yuhd
黍	uuhd
戻	lwhd
戻	lihd
煉	lmhd
燈	dghd
税	uvhe
焼	yche
焼	uche
禿	tuhe
房	fhhf
雇	guhf
稚	vihf
戯	xihg
秋	qqhh
炎	yjhh
燃	rjhh
炉	luhh
黒	hwhh
燭	vuhi
虎	huhj
稀	xihj
和	hehk
和	hohk
和	huhk
稿	gchk
熔	rshk
虜	luhl
焚	ffhm
煤	mwhm
燥	zchm
燦	cjhm
委	wwhn
秩	vihn
稼	jxhn
照	vcho
香	xlho
肩	jmho
稽	jiho
膚	fuho
稲	dcho
然	rjhp
秘	mihp
秘	bihp
秀	xqhp
穆	muhp
秒	mnhp
彪	bnhp
勲	xyhp
勲	xyhp
租	zuhq
煎	jmhq
炊	ivhq
焦	jnhr
黛	ddhr
私	sihs
熊	xshs
煮	vuht
煙	yjht
熱	reht
畑	tmht
科	kehu
秤	ighu
稗	bdhu
程	ighw
熟	uzhw
熟	uuhw
烹	pghw
称	ighx
称	ifhx
稔	rfhx
慮	lvhx
穂	svhx
穏	wfhx
扇	ujhy
煽	ujhy
穣	rhhy
穫	hohy
季	jihz
蝉	ijia
厘	liia
蝋	laia
軸	vzia
輩	bwia
願	yria
贋	yjib
辱	ruic
厨	iuic
輪	lyic
蛾	eeid
蟻	yiid
輔	fuid
輸	uuid
輯	jiie
雁	yjif
蜂	fgif
較	jnif
虹	hsig
載	zdig
轟	hsii
蟹	xpij
軌	gvij
斬	vjij
唇	iyik
蜘	viik
蛤	haik
蛤	geik
轄	xxik
励	liil
蝶	dpim
辰	ifin
蛸	xnio
暦	liio
蛎	liip
軟	rriq
厭	yjiq
螺	lois
転	vris
齢	lkis
蛙	wait
蛭	viit
軽	qkit
圧	yait
軒	xriu
蛇	ueiv
厄	eeiv
厩	jqiv
虻	mgiv
歴	liiv
砲	pciv
蚊	wfiw
轍	veiw
廠	ihiw
原	yrix
蝦	xxiy
厚	hziz
釧	irja
鉢	boja
錘	ivja
鍾	vsja
鐘	vsja
鎖	sojb
鎮	vfjb
鋳	vujc
凡	fjjd
帆	fjjd
夙	sujd
釘	dkjd
釣	dnjd
銚	ycjd
銚	tnjd
銚	dnjd
鋪	pujd
録	lujd
鎧	kdjd
鐙	dgjd
銃	isje
銑	xmje
銑	xije
鋼	gjje
鏡	jkje
鋒	fgjf
錐	vvjf
雑	zajf
幌	hljg
銭	qmjg
鍔	eejg
鍬	qnjh
鳳	fgjh
触	iuji
風	fgji
錦	jbjj
帖	tpjk
覧	ljjk
釦	kzjk
鈷	gujk
鉛	qmjk
銅	tsjk
銘	mkjk
鋸	jujk
鋸	jujk
鍋	gojk
鏑	dijk
鋤	iujl
鑑	jmjm
解	jpjn
解	xpjn
鉄	tpjn
鉾	mzjn
銀	ybjn
錬	lmjn
鎌	jkjn
鎌	lmjn
帳	vhjn
帽	mcjo
旭	xujo
錆	qljo
錯	cojo
錫	xijp
欣	xbjq
欽	qbjq
錠	dkjr
鈴	lkjs
鉱	gljs
幅	fujt
幡	fjjt
錨	mcjt
針	vfju
鐸	doju
鈍	dyjv
鉦	vgjv
幣	bijx
鍍	dujy
鍛	drjy
鍵	jmjz
日	rika
山	ujka
目	muka
叫	jnka
巨	juka
臣	ifka
哩	lika
匪	fwka
喧	xrka
嘘	xuka
嘘	uika
唾	toka
咋	zeka
咋	zaka
咋	vaka
皿	mbka
唖	yaka
噸	dyka
囲	wwka
顎	eeka
只	vikb
唄	bwkb
唄	bdkb
噴	pfkb
噂	zykc
団	trkc
因	ybkd
咽	yjkd
咽	yekd
嘱	vukd
圃	pukd
臥	wokd
諮	zikd
咲	grkd
喫	iikd
嚇	xxkd
嚇	hekd
四	sike
兄	xske
匹	pike
呪	vzke
唯	wwkf
哲	vekf
吃	iikg
号	hckg
哉	zdkg
啓	qikh
吊	dnkj
匠	jlkj
匝	zakj
回	hvkk
同	tskk
器	qikk
品	pbkk
固	gukk
匿	nikk
嗣	sikk
臨	lbkk
呂	lvkk
噛	npkk
岡	ghkk
呆	ddkm
困	kykm
喋	vakm
喋	dpkm
吸	xikn
味	wwkn
啄	vokn
詠	yskn
喚	hrkn
嘆	tjkn
骨	guko
唱	ihko
哨	ucko
噌	cgko
吻	wfkp
欧	oukq
吹	ivkq
叱	iikq
吠	fwkq
足	zukr
咳	kekr
囚	qqkr
轡	pwks
緊	jbks
吐	tukt
呼	huku
叶	yeku
叶	xpku
医	yiku
田	tmku
喉	hzku
嘩	hxku
喝	hekv
吟	ybkv
邑	yikv
吋	cykv
嚇	xxkv
嚇	hekv
圏	qrkv
圏	jrkv
網	whkv
国	gokw
呈	igkw
匡	klkw
唆	sokw
区	qukx
区	oukx
凶	xskx
図	tukx
殴	ouky
園	yrky
立	lila
端	drla
童	tsla
麟	lbla
耕	ggla
顔	yjla
龍	lsla
韻	yylb
聾	lsle
競	jkle
新	xblj
帝	dilj
親	qblj
親	qklj
加	jxlk
商	uhlk
耗	hclm
麓	lulm
努	nuln
妾	qpln
音	yblo
靖	qklo
脅	xplo
彦	yjlp
彰	vhlp
勢	uilt
塵	iflt
章	vhlu
辛	xblu
竜	lslv
竣	jylw
毅	yily
襲	xily
棒	bhma
桶	tsma
桓	hrma
檀	tjma
柚	yzma
類	lwma
馴	xyma
柵	vama
柵	ujma
柵	cema
桝	jpma
極	jima
構	gzma
樺	hxma
盃	bwma
糧	llma
横	hgmb
棋	qimb
柏	bomb
柏	bdmb
盆	pfmb
粕	pomb
糞	ffmb
村	cymc
械	xpmc
樽	zymc
柑	gjmc
闘	iumc
梼	tcmc
梼	izmc
梼	dcmc
樹	uumc
模	mumd
模	momd
梅	mwmd
杯	bwmd
梁	llmd
盗	dcmd
粉	ffmd
染	rjmd
桃	tcmd
朴	pumd
朴	pomd
朴	pnmd
渠	qumd
杓	ucmd
杓	bnmd
桁	hhmd
桁	hgmd
檎	qbmd
関	grmd
柊	vsmd
栴	vjmd
桟	vjmd
棟	dsmd
楽	lwmd
楽	ytmd
楽	lemd
様	yhmd
欄	ljmd
柳	lqme
榔	lhme
聞	wfme
櫛	vime
校	xnmf
校	jnmf
椎	vvmf
椎	ivmf
楓	fgmf
権	qrmf
盛	ugmg
盛	igmg
盈	ykmg
栽	zdmg
朽	xqmg
粥	vzmg
樗	iumg
閥	famg
梨	limh
樵	qnmh
榛	vfmh
騒	scmi
机	jimj
断	drmj
析	ximj
棉	mmmj
杭	hhmj
柿	uimj
機	jimj
格	gemk
椅	yimk
枯	kumk
棺	grmk
桐	tsmk
杏	xkmk
梧	wumk
粘	vjmk
粘	nmmk
糖	thmk
橘	jumk
桔	jumk
桔	jpmk
問	wfmk
開	kdmk
閣	gemk
閤	hemk
閤	gemk
駒	jumk
騎	qimk
槍	qlmk
橋	qnmk
監	jmmk
架	jxml
粒	liml
駕	jxml
林	lbmm
森	sfmm
閑	xmmm
梱	kymm
櫨	lumm
根	gfmn
楼	lzmn
柄	bkmn
杖	vhmn
株	vumn
橡	xlmn
梗	ggmn
糠	khmn
駅	yimn
験	yjmn
桜	ykmn
棲	ximn
棲	qimn
検	jmmn
相	xlmo
精	jkmo
盟	mgmo
糊	humo
糟	zcmo
棚	pgmo
梢	ucmo
槽	ccmo
椿	iymo
間	jmmo
闇	anmo
楯	uymo
楯	dymo
櫓	lumo
材	cdmp
梯	timp
彬	bbmp
杉	ujmp
杉	uamp
閉	bimp
楊	yhmp
益	yimq
粗	cumq
植	vimq
楚	iumr
集	jimr
核	humr
核	hemr
閃	ujmr
松	ssms
桧	hvms
桧	gvms
罵	mams
杜	dumt
桂	gvmt
樫	jmmt
料	lnmu
楠	njmu
杵	iumu
梓	zimu
樟	vhmu
柘	vemu
粋	tvmu
粋	cvmu
概	gdmv
柴	idmv
枕	vfmv
札	vamv
杷	pamv
柁	tomv
柁	domv
枇	pimv
馳	iimv
椀	wjmv
盤	pjmv
柱	vumw
栓	urmw
閏	rymw
駐	vumw
駿	jymw
稜	lkmw
稜	lgmw
禁	jbmx
栖	ximx
栖	qimx
枢	uumx
椋	llmx
駁	bomx
駆	qumx
悶	mfmx
標	bnmx
板	bjmy
枝	vimy
椴	drmy
李	limz
孟	mgmz
槌	ivmz
嬬	runa
鴨	yana
嬰	yknb
鵜	tinb
特	tenc
妖	ycnd
婆	pond
姿	zind
姻	ybnd
鴛	yrnd
鶴	hend
犠	xind
先	xmne
島	dcne
姓	xknf
牲	ugnf
妨	fhnf
鳥	nnnh
鳥	dnnh
婦	funj
鳩	jqnj
如	runk
始	uink
告	gcnk
姑	gunk
嬉	xink
嫡	dink
姶	yank
姶	eenk
鳴	mknk
鴎	ounk
甥	ugnl
媒	mwnm
娘	nlnn
妹	mwnn
嫁	jxnn
嫌	xmnn
娠	ufnn
姦	jmnn
鵠	hunn
婚	hyno
婿	xuno
娼	ihno
物	wunp
妙	mnnp
鴇	bcnp
姐	jpnq
鳶	yrnq
鵡	wunq
娃	want
牡	munt
姪	vint
嫉	jinu
妊	rfnu
妃	fwnv
姥	lcnv
娩	mmnv
牝	pbnv
鶏	jinv
鷲	jqnw
奴	nuny
妓	jiny
媛	yrny
嬢	nlny
好	hcnz
鷺	lunz
量	lloa
背	bwoa
睡	uvoa
替	tioa
胆	djoa
瞬	uyoa
昨	zooa
旦	djoa
督	duoa
瞳	tsoa
腫	vsoa
臓	zhoa
題	tioa
顕	xmoa
昇	ugoa
貝	bwob
肘	vzoc
昇	ugoc
時	uioc
暴	bcod
膝	xiod
朕	vfod
膜	mood
晦	hvod
眺	tnod
曝	bcod
腺	xmod
脚	jnoe
脱	tooe
昂	ahoe
見	jmoe
暁	xnoe
星	xkof
曜	ycof
肪	fhof
晃	hlog
腔	qlog
暫	zjoi
肌	jioj
肺	fwoj
胸	xsok
昭	vcok
胎	tdok
膳	ujok
胴	dsok
脳	ncok
腎	ufok
肋	lwol
肋	leol
勝	ugol
騰	tgom
眼	yjon
腰	ycon
映	ykon
昧	mwon
豚	tyon
脈	moon
脈	mdon
脹	vhon
膿	nson
鵬	pgon
明	mkoo
暗	anoo
朋	pgoo
冒	mcoo
晶	jkoo
晴	qkoo
昌	ihoo
脂	vioo
暑	uuoo
曙	uuoo
影	ykop
易	yiop
膨	pgop
腸	ihop
眠	mmoq
是	uior
肱	gsos
曇	tjos
睦	muot
早	zcou
智	viou
肝	gjou
脆	cvov
昆	kyov
肥	fwov
腕	wjov
鼎	dkov
胞	bcov
匙	uiov
匙	iiov
晩	wjov
腹	fuow
旺	whow
景	jkox
瞥	ppox
晒	udox
臆	yiox
県	xmox
瞭	lnox
瞭	leox
最	zvoy
服	fuoy
股	guoy
暖	nroy
肢	vioy
暇	xxoy
腿	tvoz
手	uzpa
用	yspa
神	ufpa
重	vspa
重	ispa
丹	djpa
牛	nqpa
竹	vupa
鼻	bipa
川	irpa
垂	ivpa
袖	xqpa
斤	jbpa
丘	qqpa
禅	ujpa
禅	ijpa
臼	jqpa
舛	irpa
順	uypa
須	xupa
頗	popa
頴	ykpa
穎	ykpa
兵	bkpb
興	xkpb
輿	yupb
禎	vfpb
升	ugpc
甜	tmpc
祷	dcpc
我	wopd
多	dopd
外	wdpd
初	iupd
奥	aopd
夕	xipd
斥	iipd
舟	vzpd
兆	vcpd
禄	lupd
卵	lrpd
補	bupd
襖	aopd
月	ytpe
岳	ytpe
祝	vupe
卿	qkpe
生	ugpf
九	jqpg
灸	jqph
烏	wuph
所	sopj
祈	qipj
視	uipj
帥	ukpj
師	uipj
后	hzpk
向	xlpk
名	mkpk
周	vzpk
舌	uepk
裕	yupk
裾	jupk
袷	qxpk
喬	qnpk
祐	yzpk
禍	hopk
動	dspl
血	xtpm
血	xppm
禾	hepm
牒	dppm
人	rfpn
入	rupn
失	uipn
及	jipn
八	bapn
久	jqpn
朱	vupn
爪	vxpn
爪	vcpn
瓜	gxpn
乏	fapn
裸	lopn
乗	igpn
乗	ugpn
釈	uipn
自	zipo
白	bdpo
昏	hypo
盾	dypo
旨	vipo
身	ufpp
被	bwpp
被	pipp
祖	zupq
氏	uipq
臭	xqpq
臭	izpq
祇	qipq
祇	vipq
疑	yipr
系	xips
系	jips
鬼	gvps
係	xips
係	jips
福	fupt
社	uept
番	pjpt
番	fjpt
裡	lipt
乎	hupu
千	qmpu
牌	pdpu
辞	cipu
卑	bwpu
阜	fupu
壬	rfpu
片	pmpv
乱	lrpv
礼	lipv
毛	mcpv
鼠	uupv
褐	hepv
胤	ybpv
祉	vipv
衿	jbpv
祭	jipx
襟	jbpx
祢	mipx
禰	mipx
反	fjpy
段	drpy
翻	fjpy
版	bjpy
祥	xlpy
狸	liqa
酋	qqqa
並	bkqa
猟	lpqa
其	qiqb
具	juqb
狽	bwqb
尊	zyqc
狩	uzqc
前	qmqd
切	qpqd
式	uiqd
狐	huqg
独	duqi
斯	siqj
獅	uiqj
狗	gzqk
助	vuql
勘	kjql
猛	mgqm
狼	lhqn
兼	jmqn
狭	xxqn
首	uzqo
期	qiqo
普	puqo
猪	vuqo
朔	uoqo
欺	qiqq
狙	juqq
猷	yzqq
獄	yuqq
猫	mcqt
碁	qiqu
甚	ufqv
犯	fjqv
狂	klqw
瓶	pkqw
気	qiqx
猿	yrqy
猶	yzqy
獲	hoqy
但	djra
年	nmra
作	zora
体	tira
伸	ufra
舞	wura
律	lvra
介	jpra
伴	bjra
仲	vsra
儒	rura
乍	vara
俸	fgra
俳	pdra
偉	wwra
備	bwra
傭	ysra
傾	qkra
領	lkra
毎	mwra
金	jbrb
伯	borb
伯	bdrb
供	gsrb
偵	vfrb
債	vdrb
償	ihrb
得	derc
得	dwrc
待	ddrc
付	furc
偏	pmrc
侍	uirc
併	bkrc
併	bkrc
倫	lyrc
行	xkrd
行	hhrd
倒	dcrd
代	ddrd
低	dird
停	tkrd
街	jprd
例	lird
偶	ourd
衡	hgrd
俄	eerd
矢	uird
侮	wurd
禽	qbrd
俣	yurd
術	uurd
衛	wwrd
衝	isrd
側	vdrd
側	cerd
側	zdrd
僕	purd
儀	yird
命	mkre
仙	xmre
御	yure
仰	yhre
仁	rfre
催	cvrf
傍	bhrf
佼	jnrf
僅	jbrf
径	jkrg
伐	farg
佐	zorg
乞	qirg
余	yurh
徐	xurh
偽	wwrh
無	wurh
無	morh
仇	qqrj
仇	izrj
観	grrj
何	herk
信	xbrk
合	herk
合	gerk
含	hjrk
倍	bwrk
俗	surk
佑	yzrk
伺	sirk
伺	cirk
伽	qprk
伽	jxrk
伽	gark
缶	fzrk
缶	grrk
侶	lvrk
倉	chrk
個	gerk
僑	qnrk
位	wwrl
勧	qrrl
保	bcrm
休	xqrm
傑	jprm
便	pmrn
便	bmrn
使	uirn
像	xlrn
件	jmrn
食	yirn
食	uirn
食	sirn
侠	xxrn
倭	worn
倹	jmrn
借	jpro
僧	sgro
循	xyro
儲	iuro
修	xqrp
伊	yirp
彼	birp
傷	uhrp
伏	furq
歓	hrrq
似	uirr
徒	turr
従	turr
従	csrr
会	hvrs
会	kkrs
令	lkrs
伶	lkrs
仏	fors
仏	furs
仏	fors
仏	furs
伝	irrs
伝	vrrs
伝	irrs
伝	vrrs
佳	jxrt
佃	tmrt
佃	dmrt
什	uiru
什	ufru
任	rfru
候	hzru
午	wuru
侯	hzru
斜	xpru
僻	piru
仕	uiru
倖	xkru
傘	sjru
他	tarv
今	jbrv
化	hxrv
征	vgrv
企	qirv
倦	jrrv
俺	anrv
侃	kjrv
値	virv
全	qrrw
住	vurw
微	wwrw
往	whrw
俊	jyrw
伍	wurw
覆	furw
後	hzrw
徽	hvrw
複	furw
倣	fhrw
優	yzrw
復	furw
徴	vgrw
僚	lnrx
価	jxrx
価	jprx
係	xirx
係	jirx
偲	sirx
億	yirx
億	yirx
徳	derx
依	yiry
侵	qbry
役	yiry
叙	xury
伎	jiry
仮	jxry
俵	bnry
隻	viry
仔	zirz
仔	zdrz
促	curz
健	jmrz
予	yusa
預	yusa
糾	jqsa
紐	nqsa
紬	yzsa
紳	ufsa
緋	fwsa
編	bmsa
緬	mmsa
緯	wwsa
繊	visa
繊	xmsa
繊	qmsa
繍	xqsa
縮	sosb
績	jisb
弁	bmsc
紺	gjsc
縛	fusc
約	ytsd
約	ycsd
納	nasd
紛	ffsd
終	vssd
続	xusd
緑	lvsd
緑	lusd
線	xmsd
罰	fasd
允	yyse
統	tsse
紡	fhsf
絞	jnsf
維	wwsf
羅	losf
幾	jisg
紅	hssg
織	visg
綿	mmsj
締	disj
台	tdsk
紹	ucsk
結	jpsk
絡	losk
絡	lcsk
給	gwsk
給	jisk
綱	ghsk
縞	gcsk
繕	ujsk
勇	yssl
務	wusl
柔	rzsm
繰	scsm
繰	qnsm
予	yusn
牟	mzsn
牟	musn
級	jisn
練	lmsn
縁	yrsn
署	uuso
響	xlso
絢	xrso
絹	jrso
緒	xuso
参	cjsp
参	ufsp
矛	mcsp
紗	uasp
罷	pisp
罷	basp
置	visq
紙	visq
組	zusq
繁	fjsr
綻	vjsr
縦	zssr
罪	zvss
紘	hsss
絃	xmss
絵	hvss
細	xist
経	jkst
纏	ijst
能	ngsv
紫	zisv
紀	jisv
純	iysv
継	jisv
縄	ugsv
紋	wfsw
綾	lksw
綜	zssx
綬	uzsy
綴	vvsy
緩	hrsy
縫	fgsz
至	vita
界	jpta
型	xkta
坦	tjta
埋	mjta
埋	mdta
坤	kyta
畔	pjta
垣	yrta
壇	tjta
畢	bita
室	uitb
填	tmtb
墳	fftb
異	yitb
封	fgtc
寺	sitc
塀	pbtc
赤	iitd
均	jytd
赫	hetd
卦	gxtd
町	tktd
町	dktd
執	vitd
塗	tutd
境	jkte
堕	hvte
堕	dote
堀	kute
墜	vvte
堆	dvtf
坊	fhtf
考	kctg
戴	ddtg
塊	kktg
墨	moth
坑	kgtj
略	lttk
域	yutk
塔	tatk
培	pwtk
塘	thtk
垢	gztk
埼	qitk
堅	jmtk
男	njtl
劫	jptl
塩	yjtm
畏	wwtn
壕	hctn
堰	yjtn
塚	vstn
者	veto
堵	duto
胃	wwto
増	zgto
留	lqtp
場	ihtp
基	jitq
塑	sutq
埴	vitq
畳	tptq
畳	dptq
走	zztr
坐	zotr
座	zotr
堤	ditr
去	quts
累	lwts
圭	gvtt
畦	qitt
塁	lwtt
幸	xktu
壁	bitu
坪	pktu
埠	butu
地	detv
地	ditv
老	lctv
城	igtv
堪	kjtv
墾	kftv
塾	uutw
堂	thtx
坂	bjty
報	bcty
壊	hkty
壌	rhty
孝	xntz
士	uiua
土	tuua
餐	cjua
届	jpua
矩	juua
昼	vzua
矧	ufua
韓	hjua
顛	dmua
碩	uoua
真	vfub
射	ueuc
研	yjuc
博	bouc
碍	aiuc
尉	yuuc
尉	wwuc
餅	bkuc
尽	jbud
属	uuud
属	vuud
短	drud
尤	yzud
尿	nnud
砥	diud
餓	eeud
磯	jiud
克	keue
売	mdue
餌	erue
雄	xsuf
碓	dvuf
準	vyuf
確	qtuf
左	zoug
乾	qmug
乾	gjug
戟	jiug
灰	hvuh
礁	jnuh
蝕	uiui
撃	jiui
布	buuj
尻	kcuj
飢	jiuj
飾	uiuj
硯	yjuj
知	viuk
喜	xiuk
古	guuk
居	juuk
右	yzuk
局	juuk
吉	jiuk
屈	quuk
嘉	jxuk
砧	vfuk
飴	yiuk
飼	siuk
館	gruk
矯	jnuk
勃	bwul
勃	boul
協	xpul
尾	wwum
展	vjun
硬	ykun
尺	iiun
屡	lvun
犀	xiun
喪	shun
隷	liun
有	yzuo
看	kjuo
朝	vcuo
朝	icuo
胡	huuo
屠	tuuo
屑	xpuo
馨	xbuo
硝	xnuo
層	cguo
声	ugup
破	poup
砂	uaup
砺	liup
屍	uiup
直	viuq
献	xmuq
款	kruq
隼	syur
碇	dkur
飲	ybur
礎	iuur
索	sous
磁	cius
在	zdut
屋	wuut
南	njuu
碑	bwuu
斡	wouu
幹	gjuu
砕	svuu
尼	niuv
碗	wjuv
磐	pjuv
硫	lquv
壱	yiuv
飽	bcuv
饗	xluv
碧	biuw
履	lvuw
躯	quux
友	yzuy
支	viuy
殿	dmuy
鼓	guuy
翰	hjuy
飯	fjuy
殻	keuy
殻	qnuy
穀	guuy
存	cyuz
了	leva
了	lnva
子	ziva
女	nvva
弗	fuva
丑	izva
笛	diva
丞	igva
舜	uyva
箪	djva
頻	pbva
弔	dnva
筆	biva
粛	xuva
粛	suva
舶	bovb
箕	jivb
巽	xyvb
箔	bovb
等	dgvc
算	srvc
爵	jtvc
符	fuvc
篇	pmvc
簿	buvc
笑	xnvd
武	wuvd
母	muvd
箭	jmvd
筑	vuvd
飛	fwvd
貌	mcve
竺	vuve
節	jpve
雌	civf
幻	hrvg
弓	gsvg
筏	favg
醜	izvg
災	zdvh
蛋	djvi
航	hhvj
管	grvk
答	davk
君	jyvk
船	irvk
筒	tsvk
函	hjvk
笥	sivk
歯	iivk
箇	gevk
幼	yzvl
筋	jbvl
笠	livl
采	cdvm
艦	jmvm
築	vuvm
篠	xnvm
篤	duvm
又	yzvn
承	igvn
策	cevn
妥	tovn
笈	jivn
艮	gfvn
簾	lmvn
肯	kfvo
眉	mwvo
箱	xlvo
籍	jivo
箸	vuvo
書	uuvo
簡	jmvo
第	divp
彩	cdvp
歩	buvp
民	mbvq
以	yivr
疋	pivr
舷	xmvs
纂	zrvs
畿	jivt
竿	gjvu
砦	vdvu
也	yevv
己	jivv
此	civv
巴	bavv
既	jivv
豹	bcvv
疏	uuvv
乳	ruvv
舵	dovv
巳	sivv
発	favv
範	fjvv
愛	aivw
糸	mivx
糸	sivx
受	uzvy
般	bjvy
群	qyvy
皮	pivy
簸	bovy
収	uzvy
髪	favy
艇	tkvz
理	liwa
政	vgwa
救	jqwa
致	viwa
瑞	rvwa
珊	ujwa
斐	fwwa
亨	hgwa
敷	fuwa
憂	yzwa
斉	qiwa
斎	vdwa
六	lqwb
六	luwb
敗	bdwb
散	sjwc
弄	nswc
敬	jkwc
就	jqwd
玉	yuwd
夜	yewd
球	qqwd
亦	yiwd
冬	dswd
亭	tkwd
斌	bbwd
玩	wjwe
充	iswe
聖	ugwe
放	fhwf
交	jnwf
離	liwf
攻	gswg
蛮	mjwi
市	uiwj
亮	llwj
処	iuwj
現	xmwj
高	gcwk
各	gewk
言	yjwk
吾	wuwk
珂	kewk
劾	hewl
効	xnwl
敵	diwl
数	uuwm
条	tnwm
琳	lbwm
枚	mwwm
棄	qiwm
珠	vuwn
豪	hcwn
牧	muwn
妄	whwn
琢	vown
瑛	ykwn
玖	jqwn
牽	qmwn
畝	muwn
育	yuwo
盲	mhwo
瑚	huwo
膏	gcwo
方	fhwp
珍	vfwp
敏	mbwr
亥	hdwr
徹	iewr
玄	xrws
玲	lkws
璃	liws
教	jnwt
畜	xuwt
畜	iuwt
赦	uewt
故	guwu
率	ukwu
率	lvwu
卒	zuwu
卒	cuwu
敢	gjwv
改	gdwv
亡	whwv
琴	qbwv
琉	lqwv
琶	pawv
琵	piwv
望	whww
斑	bjww
敦	dyww
変	bmww
文	wfwx
京	jkwx
衣	yiwy
哀	aiwy
衷	vswy
衰	ukwy
褒	bcwy
裏	liwy
環	hrwy
享	xlwz
孜	ziwz
悲	bwxa
忠	vsxa
恒	hgxa
患	hrxa
愚	yuxa
憧	isxa
酉	yzxa
単	djxa
単	ujxa
単	ijxa
恵	hvxa
悪	eexa
悪	wuxa
憐	lmxa
慎	ufxb
慣	grxb
慾	yuxb
憤	ffxb
急	jixd
忍	rfxd
尖	jmxd
悔	hvxd
愉	yuxd
当	dhxe
光	glxe
党	dhxe
悦	ytxe
兇	xsxe
性	xkxf
慧	hvxf
雀	qtxf
惟	wwxf
感	gjxg
忽	huxg
恐	ksxg
惑	hoxg
瓢	pnxg
恢	hvxh
愁	izxh
蛍	ykxi
常	ihxj
希	xixj
怖	buxj
覚	jtxj
覚	jnxj
尚	uhxk
恩	enxk
悟	wuxk
恰	qxxk
営	ykxk
悩	ncxk
意	yixl
劣	lpxl
労	lcxl
想	xlxm
栗	lixm
粟	suxm
栄	rsxm
要	ycxn
快	kkxn
怒	nuxn
恨	hfxn
恕	uuxn
衆	vlxn
衆	vsxn
情	qkxo
惜	xixo
省	xkxo
省	ugxo
肖	xnxo
憎	zgxo
肴	ycxo
惰	doxo
覇	baxo
嘗	ihxo
少	ucxp
息	xixp
惨	cjxp
怨	yrxp
悉	xixp
憩	qixp
悌	tixp
慈	cixq
懸	xrxq
獣	uzxq
念	nmxr
愈	yuxr
悠	yzxr
懲	igxr
禦	yuxr
怜	lmxs
怯	qpxs
怠	ddxs
態	tdxs
思	sixt
怪	gkxt
掌	vhxu
志	vixu
慰	wwxu
悼	dcxu
挙	juxu
忙	mhxv
慌	hlxv
忌	jixv
慨	kdxv
懇	kfxv
忘	whxw
恋	lmxw
覆	fuxw
厳	yjxw
票	pnxx
憾	hjxx
惚	huxx
憶	yixx
総	zsxx
慢	mjxy
誉	yuxy
裳	uhxy
裳	ihxy
懐	hkxy
殺	uaxy
学	xtxz
惇	dyxz
需	xuya
酬	izya
酢	zoya
酢	cuya
訓	xyya
詐	vaya
誹	fwya
論	lyya
講	jlya
謹	jbya
霊	lkya
翼	yiyb
習	xiyb
警	jkyc
酎	vzyc
討	tcyc
詩	uiyc
謝	xpyc
護	huyc
美	mwyd
装	vlyd
裂	lpyd
叉	iayd
酌	voyd
裟	uayd
訂	dkyd
訴	suyd
試	uiyd
誤	wuyd
諭	yuyd
議	yiyd
醤	jlyd
義	yiyd
雪	xtye
読	duye
読	dzye
醒	xkyf
誓	uiyf
訪	fhyf
誰	uwyf
誰	uvyf
謡	ycyf
差	iayg
差	ciyg
差	idyg
裁	cdyg
誇	kxyg
識	viyg
識	uiyg
談	tjyh
蚤	zcyi
諦	diyj
露	lzyk
露	luyk
善	ujyk
酷	kuyk
酪	lcyk
詔	vcyk
詞	ciyk
詰	jpyk
詰	jiyk
話	hxyk
語	yuyk
調	tnyk
調	dnyk
諮	ziyk
諾	noyk
翌	yiyl
袈	jxyl
霧	wuyl
桑	shym
諜	dpym
謀	mzym
震	vfyn
訣	jtyn
訳	yiyn
課	keyn
謙	qmyn
養	yhyn
着	voyo
着	veyo
着	vcyo
著	vuyo
著	voyo
著	veyo
著	vcyo
霜	ulyo
醐	huyo
詣	yiyo
請	qkyo
諸	vuyo
謂	wwyo
譜	puyo
製	viyp
診	vfyp
誘	yzyp
諺	yjyp
謬	mqyp
詫	iayq
誼	yiyq
袋	ddyr
醍	tiyr
該	gdyr
羨	xmyr
零	lkys
訟	ssys
雲	yyys
雷	lwyt
翠	cvyu
弁	bmyu
計	jiyu
訊	xyyu
許	xuyu
評	pkyu
酔	zvyu
配	pwyv
託	toyv
記	jiyv
証	vgyv
詑	iayv
誕	djyv
誠	igyv
謁	yeyv
電	dmyv
酸	sryw
註	vuyw
詮	qryw
誌	viyx
認	rfyx
諒	llyx
双	ulyy
霞	xxyy
設	ueyy
詳	xlyy
諏	zzyy
譲	rjyy
譲	rhyy
醸	nlyy
醇	iyyz
酵	jnyz
謎	miyz
速	suza
遇	yuza
逐	vuza
距	juza
逼	biza
述	uuza
逗	dzza
遣	qmza
迂	yuza
踊	ysza
違	wwza
遺	yiza
迫	pozb
迫	pdzb
蹟	jizb
運	yyzb
選	xrzb
遭	zczc
跳	tnzd
逸	yizd
赴	fuzd
迩	erzd
蹴	cuzd
跡	jizd
辺	bmzd
趨	quze
逝	uizf
躍	ytzf
進	jbzf
遊	yzzf
孤	guzg
跨	kxzg
遮	vezg
践	jmzg
透	tzzh
遍	bmzh
連	lmzi
近	jbzj
蹄	tizj
路	luzk
超	iczk
週	vzzk
過	gozk
適	uizk
迦	jxzl
迷	mizm
造	zczn
踏	tazo
追	vvzp
逃	tczp
迎	ykzp
延	yjzp
廷	tkzp
返	fjzp
遁	dyzp
迭	dpzp
逓	dizp
道	dczq
送	sszq
逆	nizq
遂	svzq
遵	zyzq
途	tuzr
迄	qizr
通	tszs
孫	syzs
遠	yrzt
避	bizu
起	qizv
越	ytzv
建	jmzv
退	tvzv
迅	xyzv
孔	kszv
遥	yczv
巡	xyzv
逮	ddzv
逢	fgzw
遷	qmzx
遼	lnzx
趣	quzy
這	vezy
這	vwzy
遅	iizy
達	dazy
還	hrzy
還	hdzy
遜	xyzz
#level2
肆	siaa
冉	rjaa
髯	rjaa
丕	piaa
囗	wwaa
鬣	lpaa
卅	saaa
韭	jqaa
鬲	geaa
廾	gsaa
亞	yaaa
釐	xiaa
釐	liaa
韋	wwaa
韜	tcaa
顆	keaa
鬚	xuaa
鬥	dzaa
鮓	vaaa
鯒	ysaa
鯡	fwaa
甦	suaa
畫	hxaa
冀	jiab
鬢	bbab
鬨	hsab
專	vrac
對	dvac
戈	gead
歹	ddad
夥	hoad
禺	yuad
黻	fuad
黼	fuad
黹	viad
豐	fgad
丼	dsad
鯆	buad
鯆	puad
鯊	uaad
鰥	grad
鱧	liad
麥	mdad
兀	wuae
堯	ycae
鬩	xiae
鯢	niae
魴	fhaf
鰲	aoaf
甦	suaf
丐	gdag
戛	jxag
戛	gaag
麪	mmag
麪	mmag
焉	yjah
臻	vfah
蠹	duai
蠶	cjai
覘	ijaj
覯	gzaj
鑿	zcaj
靦	mmaj
靦	mmaj
鬧	ncaj
鰤	uiaj
髻	jiak
髫	tnak
嗇	seak
鹹	xmak
勁	jkal
勁	jbal
鰈	dpam
鰛	wfam
鰮	wfam
鱸	luam
棘	jian
柬	jman
耒	lwan
豕	uian
來	ldan
夾	jxan
夾	gaan
鮟	anan
麩	fuan
棗	zcan
睿	rvao
胄	vzao
豬	vuao
冑	vzao
鱠	kkao
晉	jbao
厂	ihap
爿	pjap
髟	bnap
鰺	ufap
虍	huaq
兩	llar
鬆	ssas
鯀	gyas
鯔	ziat
于	yuau
鮃	pkau
鱆	vhau
无	wuav
无	moav
匕	biav
匚	klav
鬮	jqav
鮑	bcav
鯤	kyav
黽	mmav
黽	mgav
黽	mbav
鰉	hlaw
鰒	fuaw
忝	tmax
鯰	nmax
鰓	sdax
鰾	bnax
鹵	luax
滷	luax
裘	qqay
鬟	hray
攴	viay
鰌	qqay
鰕	xxay
宦	hrba
疥	jpba
疸	djba
賚	ldba
頌	ssba
瘧	ycba
瘧	ntba
癲	dmba
賽	sdbb
贔	bwbb
贖	uubb
實	uibb
寶	bcbb
癩	ldbb
竇	dzbb
疳	gjbc
賻	fubc
窗	ilbd
疼	tgbd
冤	yrbd
寞	mobd
窕	tnbd
疣	yzbd
疔	dkbd
贓	zhbd
癘	libd
皚	aibd
岔	iabe
皖	wjbe
疝	ujbe
兌	dvbe
竈	zcbe
窿	lsbf
皎	jnbf
贅	vvbf
瘋	fgbf
癰	ysbf
魄	pobg
兮	xibg
穹	qsbg
賤	jmbg
痙	jkbg
痰	tjbh
寫	xpbh
帛	bobj
冪	mibj
皓	hcbk
豁	hobk
窘	jsbk
窖	jnbk
痞	pibk
痂	jxbk
痼	gubk
寤	wubk
貽	yibk
痾	oobk
痾	eebk
痾	vebk
痾	kebk
瘡	ilbk
窩	wobk
窈	ycbl
癆	lcbl
寨	vdbm
瘟	wfbm
皙	xibm
贐	jbbm
騫	qmbm
疚	jqbn
寐	mwbn
冢	vsbn
宸	ifbn
痍	yibn
痿	wwbn
豢	hrbn
貶	bmbn
賺	vrbn
賺	zjbn
贊	zjbn
瘻	lzbn
窶	jubn
窶	jubn
眷	jrbo
瘠	jibo
癇	xmbo
寥	lnbp
瘍	yhbp
皸	jybp
疽	jubq
貪	tjbr
瘰	lobs
痃	xrbs
竊	qpbs
瘤	lqbt
贄	vibt
罕	hjbu
瘴	vhbu
皋	gcbu
瘁	cvbu
搴	qmbu
賁	bibu
賁	bfbu
賣	mdbu
屓	xibu
痺	pibu
痺	bwbu
痺	bibu
癢	yhbu
竄	crbu
它	tabv
卷	jrbv
疵	cibv
疱	pcbv
貲	zibv
癧	libv
痊	qrbw
瓮	wgbw
贇	yybw
竅	qnbw
痣	vibx
賈	jxbx
賈	gubx
寇	kzby
痒	yhby
寰	hrby
皈	gvby
謇	jmby
瘢	bjby
癜	dmby
贍	ujby
寢	qbby
癬	xrby
蹇	jmbz
藏	zhca
藏	chca
菲	fwca
苒	rjca
苣	quca
苣	juca
薤	xpca
舊	jqca
蕭	xnca
蕷	yuca
薺	qica
薺	jica
顴	qrca
蓿	xucb
蘋	pkcb
蘋	pgcb
莽	mhcc
苻	fucc
蓐	rucc
蒄	grcc
蓴	iycc
蕁	xycc
蕁	qmcc
莉	licd
芬	ffcd
茵	ybcd
藕	oucd
芍	uccd
藜	licd
莓	mwcd
莪	eecd
苳	dscd
萬	wjcd
葯	yccd
蒻	rocd
薊	jicd
藐	mnce
芫	yrce
芫	yjce
茆	mcce
蒭	iuce
蕘	rcce
蒡	bhcf
藺	lbcf
蘿	locf
萼	eecg
莖	jkcg
荼	tuch
蓁	vfch
蔗	vech
葷	hyci
蒂	dicj
蓆	xicj
覲	jbcj
苟	gzck
茹	ruck
茗	mkck
茴	hvck
蒿	hcck
薹	tdck
萵	wock
蒟	juck
薔	qlck
莅	licl
蘢	lscl
勸	qrcl
葆	bccm
蘖	npcm
薀	yycm
藥	yccm
蘆	lucm
蘊	yycm
蘗	npcm
驀	mocm
茉	mocn
茱	vucn
萋	qicn
蒹	jmcn
莨	llcn
莨	lhcn
萸	yucn
艱	jmcn
莢	jxcn
萇	ihcn
藉	jpco
藉	jico
菁	jkco
葫	huco
荀	xyco
苜	muco
蓍	uico
薈	hvco
莎	uacp
莠	yzcp
蓼	lucp
蓼	lncp
蔘	ufcp
蔘	cjcp
茯	fucq
苴	jucq
苴	iacq
蕕	yzcq
歡	hrcq
苡	yicr
菘	sscs
茲	zics
茲	cics
藝	yics
蕾	lwct
薹	tdct
蔔	buct
蔔	boct
薛	xtcu
萍	pkcu
苹	pkcu
苹	pgcu
萃	cvcu
薜	bicu
蕈	xycu
蔟	cucu
莊	vlcu
范	fjcv
芒	mhcv
茫	mhcv
蔬	uucv
苞	bccv
葩	pacv
薨	hscv
蓖	bicv
菴	ancv
藹	aicv
薇	wwcw
甍	mgcw
蔆	lkcw
藪	szcw
艾	yicx
艾	aicx
蔡	cdcx
菠	bocy
葭	jxcy
蓊	wgcy
菽	uucy
芟	ujcy
蘚	xmcy
荐	jmcz
冲	isda
渊	yrda
滔	tcda
渣	vada
剌	lada
潼	tsda
湍	trda
奘	vlda
湎	mmda
冱	huda
刪	ujda
剄	jkda
殫	djda
沍	huda
淨	jkda
濟	jida
瀟	xnda
溟	mkdb
淇	qidb
黌	hsdb
殞	yydb
殯	bbdb
濆	ffdb
濱	bbdb
溥	pudc
溽	rudc
將	jldc
淪	lydc
潯	xydc
濤	tcdc
冰	bkdd
溪	xidd
兔	tudd
澳	aodd
瀑	pudd
冽	lpdd
淤	yudd
渝	yudd
瀛	ykdd
卞	bmdd
汾	ffdd
洌	lpdd
刳	kudd
剞	jidd
殪	yidd
殲	jmdd
漿	jldd
濘	nkdd
瀏	lqdd
瀾	ljdd
况	klde
浣	hrde
汕	ujde
剴	kdde
洸	glde
澆	jnde
灌	grdf
淮	hkdf
湃	pddf
滂	phdf
夸	kxdg
刎	wfdg
瓠	hudg
殘	cjdg
淺	qmdg
滉	hldg
濺	jmdg
灣	wjdg
湫	qqdh
凜	lbdh
瀉	xpdh
广	gldi
渾	hydi
沛	pwdj
浙	vedj
沂	yidj
淅	xidj
淦	gjdj
滯	vidj
哥	gedk
沾	vjdk
涵	hjdk
淌	thdk
淌	ihdk
洽	qxdk
涸	hedk
沽	gudk
溏	thdk
洳	rudk
豎	uudk
奩	lmdk
洶	xsdk
滄	chdk
劭	ucdl
渤	bodl
灑	sadl
沐	mudm
澡	zcdm
樊	fjdm
溘	kedm
渫	xpdm
馮	pkdm
馮	fgdm
滌	didm
瀘	ludm
牀	ildm
决	jtdn
泛	fjdn
漾	yhdn
殃	yhdn
濮	pudn
泱	yhdn
濂	lmdn
洙	vudn
溷	hydn
奐	hrdn
妝	vldn
浹	jxdn
淒	qidn
渙	hrdn
漲	vhdn
濛	mgdn
濛	mgdn
泪	lwdo
奢	uedo
剔	tido
溯	sudo
渭	wwdo
洵	xydo
涓	jrdo
淆	xndo
昶	ihdo
潸	ujdo
汨	mido
潴	vudo
潛	qmdo
濬	jydo
剩	ugdp
刮	gxdp
渺	mndp
涕	tidp
澎	pgdp
殄	tmdp
殤	uhdp
滲	ufdp
沮	judq
漱	uudq
泯	mbdq
欹	qidq
獎	jldq
泅	qqdr
劍	jmdr
滿	mjdr
漓	lids
泓	hsds
泗	sids
淞	ssds
潘	pjdt
奎	kvdt
涅	npdt
湮	yjdt
沺	tmdt
瀋	ufdt
瀋	ufdt
瀋	ufdt
瀋	ufdt
劈	pidu
辨	bmdu
潭	tjdu
淬	cvdu
滓	zidu
剋	kwdu
剋	kedu
壯	vldu
泙	pkdu
泙	pgdu
滸	xudu
滸	hudu
澤	zedu
泄	xpdv
淹	yjdv
剿	jndv
剿	icdv
涎	xmdv
沱	todv
豌	wjdv
匏	pcdv
宀	bcdv
沚	vidv
滬	hudv
澀	sedv
瀝	lidv
汪	whdw
浚	jydw
湟	hldw
劑	jidw
夐	xsdw
瀲	lmdw
凉	lldx
刹	uadx
刹	iadx
洒	sadx
凛	lbdx
沁	qbdx
潦	lndx
剽	pndx
淙	csdx
洫	xudx
濾	lvdx
瀰	midx
瀰	midx
瀚	hjdy
澹	tjdy
澹	djdy
溲	szdy
歿	mody
沒	mwdy
沒	mody
滾	gydy
游	yzdz
潺	ijdz
殍	pndz
陷	xmea
陲	ivea
岫	xqea
顳	npea
崢	vgea
嶼	yuea
陌	moeb
隕	yyeb
峙	viec
峙	uiec
邯	hjec
邵	uced
嶝	dged
聹	nked
豈	qied
嵎	yued
弍	ered
聊	lnee
阮	rree
聶	npee
嶢	ycee
崔	cvef
彗	hvef
糶	tnef
巍	wweg
聘	pbeg
屹	yieg
隗	wweg
隗	kveg
嵬	wweg
耿	ggeh
隰	xieh
蚩	iiei
帚	vzej
覬	jiej
崟	ybej
嶄	vjej
鄙	biek
崛	jtek
鄂	eeek
郢	ykek
峪	yuek
聒	goek
鄲	djek
卻	qtek
崗	ghek
嶇	quek
隴	lsel
隘	aiem
鄰	lbem
聚	juen
岌	jien
陝	ujen
峽	xxen
峭	qneo
嵋	mweo
隋	sveo
隋	doeo
邱	qqep
陂	poep
陂	piep
陂	bwep
陟	viep
嵌	qmeq
岷	mbeq
嶽	yteq
嶷	yier
聳	sser
險	xmer
嶮	xmer
聆	lkes
巒	lres
嶂	vheu
阡	qmeu
耻	iiev
陋	lzev
岑	cfev
郛	fuev
崑	kyev
崑	kyev
巉	ijev
隍	hlew
崚	lkew
崚	lgew
巖	yjew
祟	svex
聰	csex
聽	tkex
隱	ybex
陬	zzey
隧	svez
隨	svez
插	iafa
拂	fufa
擅	ujfa
揣	vvfa
揣	trfa
揣	ikfa
捶	ivfa
拯	vgfa
拌	pjfa
拌	bjfa
抒	uufa
旌	jkfa
抻	iffa
舂	isfa
靜	jkfa
搆	gzfa
擠	jifa
拱	gsfb
揩	kdfb
颶	jufb
擯	bbfb
擴	kofb
罌	ykfb
搏	bofc
拊	fufc
拑	qmfc
摶	trfc
擣	dcfc
拔	bafd
拆	idfd
拇	mufd
揄	yufd
揆	kvfd
搦	nofd
抃	bmfd
揀	jmfd
揶	yefe
搗	dcfe
撓	ncfe
擲	vife
攝	uefe
攝	npfe
掏	tcff
摧	cvff
罐	grff
搖	ycff
攤	tjff
找	vcfg
搓	cofg
扛	khfg
扛	ghfg
缸	ghfg
蠢	iyfi
齧	npfi
撕	sifj
旆	pwfj
帶	ddfj
攪	jnfj
攬	ljfj
抬	tdfk
扣	kzfk
拈	nmfk
拮	jxfk
拮	jpfk
掎	jifk
颱	tdfk
搶	qlfk
搶	igfk
擔	djfk
擱	gefk
攜	xpfk
拉	lafl
抛	pcfl
拗	nqfl
拗	aofl
勣	jifl
撈	lcfl
揉	rzfm
旄	mcfm
捫	mffm
擽	lefm
缺	qtfn
抉	jtfn
掖	yefn
掾	yrfn
麸	fufn
挾	xpfn
挾	jxfn
據	jufn
捐	jrfo
掀	xmfq
捩	lpfq
擒	qbfs
纛	dcfs
挂	gxft
捏	npft
擂	lwft
擡	tdft
掉	dnfu
抖	dzfu
捍	hjfu
罅	xxfu
扞	hjfu
擇	vdfu
擇	zefu
抓	vxfv
扎	vafv
扼	eefv
旒	lqfv
艷	yjfv
擺	bdfv
旃	vjfw
撼	hjfx
撩	lnfx
抔	pzfx
搜	szfy
攘	rhfy
攫	jtfy
撥	bofy
撻	tafz
疆	jlga
靡	miga
臧	zhga
靼	daga
戌	xuga
鬻	yuga
鞴	bwga
彈	tjga
彈	djga
廣	glgb
廚	iugc
匆	csgd
魃	bagd
魑	iigd
戍	uugd
匍	pugd
汞	gsgd
鄒	zzgd
廁	sigd
廁	cegd
弭	mige
芻	iuge
鞏	gsgg
戔	jmgg
鞦	qqgh
廡	wugh
廩	lbgh
虱	uigi
髑	dugi
覡	xigj
廝	sigj
咸	xmgk
匈	xsgk
骼	gegk
勒	lwgl
勒	legl
劬	qugl
麾	hvgm
糜	mwgm
鞣	rzgm
廬	lugm
盞	vjgm
弩	nugn
鞅	yhgn
廨	xpgn
髏	lzgn
膺	ykgo
廂	xlgo
弸	pggo
廖	lngp
皺	vzgp
巫	wugr
魎	llgr
縻	migs
麼	mogs
麼	megs
麼	ycgs
鞋	xpgt
甸	dmgt
匐	fugt
廛	ijgt
瓣	bjgu
髀	bigu
魍	whgv
廈	xxgw
廈	uagw
廳	tkgx
彌	migx
應	ykgx
骰	tzgy
庠	xlgy
鞫	jugy
廢	fwgy
孕	yygz
蹙	cugz
髓	svgz
韃	dagz
韆	qmgz
炸	vaha
稻	dcha
炬	juha
燹	xmha
顱	luha
稱	igha
稱	ifha
黷	duhb
熾	iihb
扁	pmhc
扁	bmhc
烟	yjhd
黎	lihd
穢	hvhd
燒	uche
熬	aohf
烽	fghf
魏	wwhg
虧	kvhg
戲	xihg
燻	xyhh
燻	xyhh
羆	pihh
螢	ykhi
處	iuhj
熙	xihk
炯	jshk
烙	lohk
烙	lchk
黏	nmhk
黠	xxhk
稠	izhk
黜	iuhk
焙	bwhk
點	dmhk
烱	jlhk
烱	jshk
營	ykhk
穡	sehk
黝	yzhl
勞	lchl
杰	jphm
榮	rshm
燼	jbhm
爍	uohm
爐	luhm
盧	luhm
炳	bkhn
秧	yhhn
秣	mohn
燠	yuhn
鶯	ykhn
煥	hrhn
犖	lohn
稍	ucho
黯	anho
煦	xuho
熏	xyhp
炒	ichp
煬	yhhp
默	mohq
歔	xuhq
獻	xmhq
爛	ljhs
燔	fjht
塋	ykht
熹	xihu
熨	yyhu
熨	yuhu
煢	qshu
稈	gjhu
炮	pchv
炮	bchv
扈	huhv
黔	qmhv
秕	bihv
烝	vghv
焜	kyhv
煌	hlhw
虔	qmhw
稷	jihw
馥	fuhw
燉	dyhw
瑩	ykhw
熄	xihx
穗	svhx
燎	lnhx
黥	qkhx
穩	wfhx
翩	pmhy
羔	gchy
穰	rhhy
燬	hvhy
燧	svhz
蠕	ruia
蛹	ysia
蚯	qqia
蚓	ybia
蜚	fwia
蚰	yzia
輦	nmia
靨	yeia
螟	mkib
蟒	mhic
蟒	mgic
蝙	bmic
蚶	hjic
轉	vric
蜈	wuid
蟆	maid
蚋	rvid
蝓	yuid
蜊	liid
蠣	liid
軾	uiid
輳	czid
齲	quid
螂	lhie
蛻	tvie
蟯	ncie
蛟	jnif
蚌	bhif
蚌	bgif
螯	aoif
蛩	qsig
輕	qkig
孅	xmig
孅	qmig
魘	yjig
蜍	iuih
黶	yjih
蜃	ufii
蟲	isii
厮	siij
蜥	xiij
蜆	xmij
蛔	hvik
蛄	guik
蛞	koik
蜩	tnik
蝸	woik
軻	keik
輅	luik
轎	jnik
齠	tnik
齬	yuik
轆	luil
勵	liil
蠑	rsim
轢	liim
轤	luim
蛛	vuin
螻	lzin
軼	yiin
輾	vjin
輾	nmin
輾	zjin
齦	ybin
齦	kfin
蝴	huio
蜻	qkio
脣	iyio
蝟	wwio
蜴	yiip
軫	vfip
厖	mhip
厥	jtiq
蛆	quiq
蠍	xpiq
齟	juiq
仄	zeir
輛	llir
蚣	gsis
蛉	lkis
蠻	mjis
齡	lkis
蝠	fuit
蟠	pjit
螳	thit
螫	veit
螫	uiit
蟄	veit
輊	viit
輜	ziit
輻	fuit
壓	yait
齷	woit
蚪	dziu
蟀	ukiu
蝌	keiu
蝎	xpiv
蜷	qriv
蜒	yjiv
蜿	wjiv
蠅	ykiv
軋	yaiv
軋	vaiv
軋	gaiv
軛	eeiv
輒	veiv
輓	wjiv
轣	liiv
齔	ifiv
厦	xxiw
厦	uaiw
蝗	hliw
蝮	fuiw
蟶	igiw
愿	yrix
蟋	xiix
轗	kjix
蟾	ijiy
蠖	hoiy
輟	ioiy
轅	yriy
蜉	fuiz
蝣	yziz
齪	ioiz
幢	vlja
幢	ilja
鈕	nqja
鉅	juja
錚	vgja
幃	wwja
幗	goja
釟	bajb
鏥	xqjb
鑽	zrjb
幀	vfjb
鉗	qmjc
鏘	qljc
鑄	vujc
鑰	ytjc
鑰	ycjc
釵	idjd
鈞	jyjd
鉉	xrjd
鉞	ytjd
鍮	tzjd
鉚	mcje
鐃	ncje
鑷	npje
帷	wwjf
鑼	lojf
觚	gujg
錢	qmjg
鐫	jrjg
鐵	tpjg
幟	vijg
觸	iuji
鏨	zjji
咒	vzjk
覽	ljjk
鉅	jujk
鉤	gzjk
銛	xmjk
銛	tmjk
銛	gxjk
錮	gujk
鍼	vfjk
鎔	rsjk
鎬	hcjk
鎬	gcjk
鑒	jmjk
鎰	yijm
鑠	uojm
帑	thjn
帑	nujn
帙	vijn
銖	vujn
鋏	jxjn
鏤	lzjn
馗	kvjo
銷	xnjo
觴	uhjp
鈔	icjp
鏐	lqjp
凭	pkjr
鑾	lrjs
幄	wojt
鈿	tmjt
鈿	dmjt
錙	zijt
鏗	kgjt
鐇	fjjt
鐺	igjt
鐺	dhjt
斛	huju
鏃	zuju
鐔	xbju
鐔	tjju
鐔	ijju
觜	zvjv
觜	zijv
鉈	tojv
鉈	tajv
鉋	pcjv
鉋	bcjv
鋩	mhjv
鑞	lajv
凰	hljw
銓	qrjw
鍠	hljw
鐓	dvjw
鍄	lljx
鐐	lnjx
幔	mjjy
殳	uujy
鈑	bjjy
鏝	mjjy
鐶	hrjy
钁	jtjy
鏈	lmjz
喘	irka
曰	ytka
呻	ufka
匣	xxka
呷	xxka
譁	hxka
啗	djka
單	ujka
單	ijka
單	djka
嘯	xnka
國	goka
圍	wwka
頤	yika
哄	hskb
嗔	ifkb
叭	bakb
匱	kvkb
匱	gvkb
嘖	zekb
圓	yrkb
咐	fukc
嚼	jtkc
嚼	jnkc
哢	lskc
囀	vrkc
團	trkc
哦	ookd
哦	eekd
吩	ffkd
叮	dkkd
喇	lakd
叨	tckd
叨	dckd
咨	zikd
噎	yekd
哺	bukd
匯	hvkd
嚀	nkkd
體	tikd
吮	uyke
啣	xmke
囁	npke
咬	yckf
囃	zakf
雖	svkf
嗟	jpkg
戰	vjkg
啾	jqkh
啖	djkh
嗚	wukh
嚥	yjkh
嚥	yekh
嗤	iiki
囑	vuki
听	tkkj
嘴	zvkj
嘶	sikj
啼	tikj
吭	kgkj
吭	hhkj
唏	xikj
號	hckj
喨	llkj
哈	hakk
呵	hekk
喊	hjkk
咯	lokk
咯	kakk
咯	gekk
喀	kakk
唔	wukk
唔	kkm
咄	dokk
圄	yukk
嚆	hckk
冏	jskk
區	qukk
區	oukk
咼	wokk
咼	wdkk
咼	wakk
咼	hekk
咼	gxkk
咼	gokk
嘔	oukk
囂	xnkk
圖	tukk
嘛	makm
噪	zckm
咏	yskn
哽	ggkn
呱	gxkn
喙	hvkn
吽	hskn
呎	iikn
嚶	ykkn
嘲	vcko
嘲	icko
嗜	uiko
喟	kvko
囿	yzko
呀	yakp
嗅	xqkq
嗽	szkq
咀	jukq
咤	vakq
唳	likq
歐	oukq
獸	uzkq
售	uzkr
噬	uikr
嚏	tikr
吶	nekr
吶	nakr
囹	lkks
囈	yiks
哇	wakt
咥	dpkt
喃	njku
吁	yuku
吁	xuku
圉	yuku
嗾	szku
圈	qrkv
圈	jrkv
吼	hzkv
咆	pckv
罔	whkv
鬯	ihkv
嘸	omkv
嗷	aokw
嗄	uakw
嗄	aakw
嚴	yjkw
甌	oukw
网	whkx
噤	jbkx
噫	yikx
哂	ufkx
唸	nmkx
唸	nmkx
啜	ioky
啜	ikky
翳	yiky
圜	yrky
圜	hrky
呶	ncky
毆	ouky
哮	xnkz
嗹	lmkz
韵	yyla
麒	qilb
麝	uelc
耨	nzlc
竚	vuld
竟	jkle
旁	phlf
颯	salf
鏖	aolj
站	vjlk
韶	uclk
啻	iilk
耜	silk
麋	milm
辣	laln
竦	ssln
耘	yyls
竭	jplv
耙	palv
耙	balv
麈	vulw
翊	yily
盂	yuma
髦	mcma
糯	noma
粲	cjma
槿	jbma
柞	vama
杼	vuma
榧	fwma
閂	urma
閘	vama
閻	yjma
閾	yuma
關	grma
闡	ijma
椏	yama
椪	pgma
橦	tsma
橦	ilma
楷	kdmb
楷	jpmb
枳	vimb
騏	qimb
驥	jimb
梹	bkmb
槓	ghmb
檳	bkmb
檳	bbmb
櫃	jumb
櫃	gvmb
檠	qkmc
駢	pmmc
騙	pmmc
枅	jimc
榑	fumc
榑	bomc
槫	trmc
槫	urmc
槫	qrmc
檮	tcmc
檮	izmc
檮	dcmc
梦	mgmd
梵	fjmd
橙	igmd
粱	llmd
楔	xpmd
柢	dimd
柢	iimd
柝	tomd
粢	zimd
粢	cimd
閼	eemd
闌	ljmd
朮	uumd
杙	yimd
榿	qimd
樸	pumd
樸	pomd
樸	pnmd
檸	nkmd
毬	qqmd
盜	dcmd
盪	dhmd
糲	limd
档	dhme
椰	yeme
楫	jime
驍	xnme
柮	vome
槨	gome
橈	rcme
橈	ncme
楞	lgmf
榜	bhmf
枋	fhmf
騅	vvmf
櫂	yimf
櫂	vcmf
權	qrmf
槐	hkmg
杠	ghmg
栲	kcmg
槎	iamg
騁	igmg
棧	vjmg
毯	tjmh
楸	qqmh
蠱	gumi
騷	scmi
槧	qmmi
桷	jtmj
欖	ljmj
柯	kemk
枷	jxmk
榕	rsmk
槁	gcmk
梏	gumk
枸	jumk
枸	gzmk
閭	lvmk
闊	komk
駘	tdmk
駱	lomk
驅	qumk
驕	jnmk
鹽	yjmk
梠	lvmk
棡	ghmk
樞	uumk
檣	qlmk
櫚	lvmk
櫺	lkmk
驪	liml
朸	liml
橇	qnmm
糅	rzmm
楹	ykmm
毳	cvmm
闔	hemm
闖	ilmm
驢	lvmm
驫	bnmm
楙	mcmm
楪	yemm
楪	dpmm
榲	wfmm
檻	kjmm
檻	jmmm
櫟	ytmm
櫟	limm
粮	llmn
棣	timn
棣	dimn
棣	ddmn
檬	mgmn
柩	jqmn
椽	irmn
粳	jkmn
楝	lmmn
隸	limn
駑	numn
駛	uimn
驟	vzmn
樓	lzmn
樣	yhmn
櫞	yrmn
櫻	ykmn
楮	iumo
杳	ycmo
闍	uemo
闍	dumo
橢	tomo
檜	hvmo
檜	gvmo
桀	jpmp
盥	grmp
杪	mnmp
驂	cjmp
鬱	yump
粃	bamp
粃	pamp
槊	uomq
闃	qumq
闕	qtmq
柤	vamq
盒	hemr
駭	hdmr
驗	yjmr
樅	zsmr
樅	csmr
檢	jmmr
駟	sims
騾	loms
欒	lrms
榴	lqmt
桎	vimt
盍	hemt
閨	gvmt
攀	pjmu
杆	gjmu
粹	cvmu
棹	vomu
棹	vcmu
檗	bomu
槲	humu
駻	hjmu
驛	yimu
桿	gjmu
棍	gymv
梳	uumv
杞	qimv
椹	vfmv
椹	ufmv
閹	yjmv
駝	tomv
枹	bcmv
梔	vimv
槃	pjmv
樂	ytmv
樂	lemv
櫪	limv
盡	jbmv
枉	whmw
梭	somw
框	klmw
橄	gjmw
檄	ximw
閔	mbmw
馼	wfmw
棕	zsmx
粽	zsmx
槭	semx
槭	qimx
驃	pnmx
驃	bnmx
盖	gdmy
榻	tamy
檐	yjmy
栩	xumy
椒	jnmy
榱	cvmy
馭	yumy
駸	qbmy
驤	xlmy
椁	gomz
梃	tkmz
桴	fumz
闥	tamz
靠	kcna
妲	dana
媾	gzna
嬋	ijna
鴉	yana
鴦	yhna
鶇	dsna
鷯	lnna
嬪	pbnb
鶲	wgnb
鸚	yknb
犢	dunb
妍	yjnc
鵲	qtnc
鸛	grnc
姆	mund
姚	ycnd
娥	eend
娑	sond
妁	uond
嫋	nnnd
鴆	vfnd
鶺	jind
牴	dind
犧	xind
娜	none
娜	nane
娶	qune
娉	pkng
鶻	hung
鶻	gung
鷓	veng
嫣	yjnh
犁	linh
嫦	ihnj
鳧	funj
婀	eenk
犒	kcnk
牾	wunk
嫗	yunk
嬌	jnnk
鵑	jrnk
鶚	eenk
嬲	nnnl
婪	ljnm
媼	aonm
媽	manm
嫻	xmnm
梟	xnnm
樢	wunm
姨	yinn
嫐	ncnn
鴃	jtnn
犇	bfnn
媚	mwno
娟	jrno
孀	ulno
嫺	xmno
鴟	iinp
鵝	eenp
鵯	bwnp
鷽	xtnp
鷁	yinq
鴒	lknr
鴿	genr
鵐	wunr
鷦	jnnr
鶩	wuns
鷸	yuns
鷙	vint
奸	jmnu
婢	binu
嬖	binu
鴣	gunu
婉	wjnv
妣	binv
鴕	tonv
鷂	ycnv
嫩	nfnw
鵁	jnnw
鶉	iynw
嫖	pnnx
嫂	scny
娵	juny
孃	nlny
胖	phoa
胖	pjoa
腥	xkoa
暄	xroa
胚	pwoa
腓	fwoa
胛	jxoa
膈	geoa
胙	zooa
膕	gooa
臍	qioa
臑	ncoa
顯	xmoa
曄	yeoa
瞑	mkob
腆	tmob
暝	mkob
曠	klob
瞶	kvob
膊	booc
腑	fuoc
胼	pmoc
昊	hcod
脯	puod
脯	fuod
滕	tgod
晁	icod
腋	yeod
胝	viod
肭	naod
膩	niod
睨	nioe
昴	mcoe
胱	gloe
曉	xnoe
朏	kuoe
朏	fwoe
膀	phof
膀	bhof
瞿	quof
瞿	juof
膂	lvof
晢	veof
曦	xiog
胯	kxog
肛	ghog
脛	jkog
暈	yyoi
暉	hvoi
矚	vuoi
晰	xioj
晞	xioj
瞎	xxok
晤	wuok
膽	djok
勗	xuol
朧	lsol
杲	gcom
膃	waom
臚	luom
脉	moon
脉	mdon
晨	ifon
眸	mzon
朦	mgon
晏	yjon
腴	yuon
曚	mgon
眛	mwon
矇	mgon
矇	mgon
睛	jkoo
睹	duoo
膾	kkoo
睇	diop
眇	mnop
膠	jnop
暘	yhop
歇	xpoq
睫	jpor
昃	zeor
臉	lmor
瞞	mjor
瞼	jmor
眩	xros
肚	duot
瞠	igot
睚	yaot
膣	viot
臂	bwou
臂	biou
脾	piou
旱	hjou
臀	tyou
睥	piou
睥	biou
瞽	guou
眈	djov
冕	mmov
昵	niov
眦	ziov
晟	ugov
晟	igov
眄	mmov
曷	heov
臘	xiov
臘	laov
眥	ziov
瞰	kjow
暾	tyow
旻	mbow
曖	aiow
腮	sdox
腦	ncox
暸	lnox
曼	mjoy
瞻	vjoy
矍	jtoy
曩	nhoy
腱	jmoz
册	cepa
袒	tjpa
祚	zopa
釉	yzpa
襦	rupa
肄	yipa
袢	pjpa
彳	iipa
舉	jupa
彿	fupa
彿	fopa
潁	ykpa
禪	ujpa
禪	ijpa
祺	qipb
褶	vepb
與	yupb
牘	dupb
褥	rupc
褊	bmpc
舁	yupc
禹	yupd
夭	ycpd
衲	napd
褂	gxpd
祗	vipd
禊	xipd
祓	fupd
釁	xbpd
奧	aopd
祿	lupd
禮	lipd
兒	erpe
歸	gvpe
雕	dnpf
几	jipg
粤	ytpg
炙	viph
褫	iiph
爨	crph
襁	qlpi
褌	kypi
襯	ifpj
覺	jtpj
覺	jnpj
裙	qypk
祠	cipk
禧	xipk
牆	qlpk
舅	jqpl
勳	xypl
褓	bcpm
襤	ljpm
乘	ugpn
乘	igpn
秉	bkpn
袂	mwpn
臾	yupn
夂	wfpn
褸	lvpn
襪	wapn
襴	ljpn
乂	yipn
衫	ujpp
裼	xipp
裼	tipp
袗	vfpp
祕	mipp
祕	bipp
袱	fupq
舐	uipq
歃	uapq
歟	yupq
黐	iips
襠	dhpt
貍	lipt
鼾	hjpu
裨	pipu
裨	bipu
衽	rfpu
睾	gcpu
釋	uipu
儿	erpv
乖	gkpv
袍	pcpv
祀	sipv
卮	vipv
勹	bcpv
皰	pcpv
攵	wfpx
龜	qqpx
龜	jypx
龜	gvpx
慇	ybpx
殷	ybpy
殷	yjpy
叟	szpy
禳	rhpy
譽	yupy
毀	hvpy
褪	typz
褪	tvpz
孵	fupz
狒	fwqa
狎	xxqa
狃	nqqa
貳	erqb
獺	taqb
并	bkqc
犹	yzqd
氛	ffqd
剪	jmqd
奠	dmqd
弋	yiqd
氤	ybqd
獰	nkqd
猊	niqe
狡	jnqf
猩	xkqf
雎	juqf
飆	bnqf
猾	hxqg
戡	kjqg
狄	diqh
獨	duqi
哭	kuqk
猗	yiqk
馘	goqk
狠	hfqn
猥	wwqn
狹	xxqn
猜	cdqo
猖	ihqo
狷	jrqo
獪	kkqo
歉	qmqq
獗	jtqq
縣	xmqs
猴	hzqu
猝	cuqu
斟	vfqu
獵	lpqv
翦	jmqy
孳	ziqz
个	gera
佛	fora
佛	fura
价	jxra
舒	uura
僵	jlra
徘	pdra
俑	ysra
僮	vlra
僮	tsra
俚	lira
徂	cura
儕	idra
頷	hjra
彿	fura
彿	fora
彿	fura
彿	fora
偕	xprb
佰	bdrb
價	jxrb
價	jprb
傅	furc
俯	furc
龠	ytrc
侖	lyrc
傳	vrrc
傳	irrc
儔	izrc
崙	lyrc
仆	purd
衍	yjrd
衙	yard
俐	lird
侈	iird
仞	rfrd
佻	tnrd
衢	qurd
衒	xrrd
佇	vurd
銜	xmrd
倪	nire
僥	ycre
僥	jnre
彷	phrf
彷	fhrf
徭	ycrf
隹	vvrf
儺	norf
糴	dirf
截	jprg
傀	kvrg
傀	gvrg
倥	ksrg
儁	jyrg
雋	jyrg
雋	jrrg
徑	jkrg
儻	thrh
俥	ieri
佩	pwrj
伉	khrj
覦	yurj
俔	qmrj
舍	uerk
估	gurk
倚	yirk
倔	jtrk
徊	hkrk
僖	xirk
倨	jurk
佝	gzrk
佶	jirk
傴	yurk
仂	lerl
儷	lirl
龕	kjrl
們	mfrm
儘	jbrm
儘	jbrm
條	tnrm
氣	qirm
很	hfrn
仗	vhrn
偃	yjrn
侏	vurn
佞	nkrn
佚	yirn
佚	dprn
僂	lvrn
僂	lzrn
儂	nsrn
徠	ldrn
倩	qmro
藉	jpro
藉	jiro
倡	ihro
徇	xyro
僭	jmro
侑	yzro
脩	xqro
脩	xqro
會	hvro
會	kkro
仍	rgrp
倏	uurq
俎	zurq
歙	xirq
歙	uerq
侘	iarq
从	csrr
徙	xirr
倆	llrr
僉	qmrr
儉	jmrr
從	csrr
絛	tcrs
儡	lwrt
拿	naru
俟	siru
俟	qiru
俾	biru
仟	qmru
倬	voru
气	qirv
佗	torv
毓	yurv
偈	jprv
偈	jirv
做	zorw
傲	aorw
攸	yzrw
徨	hlrw
徼	jnrw
傚	xnrw
儼	yjrw
偬	zsrx
假	jxry
佯	yhry
衾	qbry
翕	xiry
俶	tiry
俶	iury
雙	ulry
俘	furz
甬	yssa
鈕	nqsa
紵	vusa
絆	bjsa
絳	jlsa
繻	xusa
纈	xpsa
繽	bbsb
續	xusb
紂	vzsc
綸	lysc
綸	grsc
縟	rusc
罘	fusd
絎	hhsd
纔	cdsd
緝	jise
繞	rcse
罹	lisf
綯	tcsf
彎	wjsg
經	jksg
纖	xmsg
纖	qmsg
綮	qish
綮	qksh
蜀	uusi
斷	drsj
纜	ljsj
罟	gusk
紿	ddsk
絅	jssk
綢	izsk
綰	wjsk
綺	qisk
緘	jmsk
紮	vasm
綵	cdsm
綵	cdsm
緤	yesm
緤	xpsm
縊	yism
繿	ljsm
羈	jism
豫	yusn
絮	xusn
綏	svsn
縷	lvsn
纓	yksn
緡	mbso
縉	jbso
繃	bgso
繪	hvso
皴	cysp
參	ufsp
參	cjsp
緲	mnsp
繆	mzsp
繆	mqsp
繆	mnsp
欸	eisq
欸	aisq
欸	vdsq
綟	lisq
縱	zssr
紜	yyss
絲	siss
縲	lwss
畚	bfst
緇	zist
罩	vcsu
矣	yisu
辮	bmsu
紆	yusu
絨	rssu
綽	iosu
綽	icsu
繹	yisu
矜	qbsv
矜	jbsv
矜	grsv
罨	yjsv
糺	jqsv
紕	pisv
紕	bisv
紲	xpsv
綣	qrsv
繩	ugsv
繼	jisv
緻	visw
縹	pnsx
總	zssx
繚	lnsx
詈	lisy
緞	drsy
縵	mjsy
縋	vvsz
縺	lmsz
墅	uuta
墟	xuta
壑	heta
堊	eeta
壙	kltb
畴	iztc
坩	gjtc
埒	lptc
塒	uitc
疇	iztc
坏	hktd
埔	putd
埔	butd
墮	hvte
墮	dote
塢	wuth
塹	qmti
圻	ybtj
圻	qitj
埆	qttj
埆	jttj
畸	jitk
堝	gotk
壟	lstl
耄	mctm
壗	jbtm
垠	ybtn
赭	veto
耆	qito
堋	pgto
堋	bgto
坡	potp
畛	vftp
坎	kjtq
疊	dptq
堡	bctr
垓	gdtr
垈	ddtr
耋	dptt
堙	ybtt
垤	dptt
壘	lwtt
埃	aitu
臺	tdtu
址	vitv
堽	ghtv
壅	ystw
袁	yrty
壤	rhty
赧	njty
壞	hkty
翹	qnty
矗	iuua
鼬	yzua
邨	cyua
頡	xpua
頡	jxua
頡	jpua
壺	huua
壼	kyua
餡	xmua
屆	jpua
咫	viub
饋	kvub
饌	vrub
磧	qiub
礦	klub
屏	pkuc
卉	hvuc
壽	uzuc
磚	vruc
碌	luud
砌	qiud
餮	tpud
壹	yiud
磴	dgud
剋	kwud
剋	keud
飫	yuud
餔	buud
饑	jiud
尨	phud
尨	mhud
尨	mgud
尨	lsud
鼕	dsud
磑	wwud
礒	yiud
礪	liud
兢	jkue
聲	ugue
饒	rcue
磽	qnue
拜	bduf
磅	phuf
磅	bhuf
雉	viuf
挈	qpuf
餃	jnuf
饉	jbuf
躬	gsug
磋	coug
餞	jmug
餘	yuuh
屬	vuui
屬	uuui
斫	vouj
覿	diuj
饕	tcuk
碚	bwuk
餉	xluk
劼	jpul
飭	iiul
屎	uium
磔	veum
碼	maum
礫	lium
礬	fjum
矮	aiun
碾	nmun
餒	nwun
拏	naun
硼	pguo
餬	huuo
彭	pgup
彭	bhup
掣	ieup
礙	aiur
礙	aiur
攣	lrus
硅	gvut
餾	lqut
摯	viut
碎	svuu
辜	guuu
磊	lwuu
辟	piuu
辟	biuu
磬	qkuu
擘	bouu
闢	piuu
闢	biuu
屁	piuv
砒	piuv
碣	jpuv
碣	yauv
尢	yzuv
飩	tyuv
懿	yiux
憙	xiux
翅	iiuy
屐	jiuy
轂	guuy
饅	mjuy
殼	qnuy
殼	keuy
孱	ijuz
孛	bwuz
笨	bfva
筝	vgva
篝	gzva
聿	yuva
亟	jiva
孑	jpva
艟	isva
舳	vuva
肅	suva
頸	jkva
頸	ggva
屮	ieva
晝	vzva
爭	vgva
箏	vgva
篳	biva
簫	xnva
簧	hlvb
貊	movb
簀	zevb
簣	kvvb
籟	ldvb
彝	yivc
箝	qmvc
笄	jivc
籌	izvc
癸	gvvd
奚	xivd
貘	movd
厶	sivd
艤	yivd
筅	xmve
笙	ugvf
舫	fhvf
籬	livf
箜	ksvg
齶	eevg
箋	jmvg
籤	qmvg
蠡	livi
蝨	uivi
箍	guvj
覓	mivj
筧	jmvj
篩	udvj
貂	dnvk
貉	movk
貉	hevk
貉	hcvk
箴	vfvk
笞	iivk
笳	jxvk
舸	gevk
艙	chvk
嚮	xlvk
齒	iivk
齣	iuvk
勦	jnvl
勦	icvl
籠	lsvl
貅	xqvm
篥	livm
艫	luvm
籃	ljvm
隶	livn
篆	vrvn
艨	mgvn
彖	trvn
廴	tkvn
夬	gkvn
彙	hvvn
筴	jxvn
篋	qpvn
簍	lzvn
簪	zjvo
胥	xuvo
艚	ccvo
筍	syvo
尸	uivp
尹	ybvp
毋	wuvp
笋	syvp
豺	idvp
豸	vivp
笏	huvp
筮	uivr
簽	qmvr
幺	ycvs
籀	vzvt
簇	cuvu
篌	hzvu
簟	dmvu
辭	civu
顰	pbvu
已	yivv
爬	pavv
筵	yjvv
笆	bavv
貔	pivv
篦	bivv
笊	vcvv
巛	vevv
亂	lrvv
筱	xnvw
筐	klvw
篁	hlvw
筌	qrvw
籔	uuvw
艘	szvy
爰	yrvy
發	favy
羣	qyvy
篷	pgvz
瑾	jbwa
敕	iiwa
亶	djwa
頏	hhwa
顏	yjwa
顫	vjwa
顫	ijwa
齊	qiwa
齋	vdwa
齎	jiwa
齏	jiwa
數	uuwa
珀	powb
贏	ykwb
瑣	sowb
弃	qiwc
瑟	sewd
瑜	yuwd
奕	yiwd
瓷	ciwd
孰	uuwd
玳	ddwd
羸	lwwd
珥	erwe
瑶	ycwf
敖	aowf
雍	yswf
雜	zawf
瑤	ycwf
弯	wjwg
瑰	gvwg
琥	huwh
稟	bkwh
螽	vswi
琿	hywi
琿	hvwi
亢	khwj
珮	pwwj
咎	jqwk
吝	lbwk
珞	lowk
珈	jxwk
勍	qkwl
瓏	lswl
毫	hcwm
氈	vjwm
瑪	mawm
琅	lhwn
璞	puwn
瓔	ykwn
瑁	mcwo
肓	hlwo
玻	bowp
氓	mhwq
氓	mgwq
亳	bowq
臠	lrwr
敘	xuwr
斂	lmwr
紊	wfws
變	bmws
鸞	lrws
琺	faws
畋	tmwt
璧	biwu
璋	vhwu
甓	piwu
收	uzwv
效	xnww
瓊	qsww
甕	wgww
禀	bkwx
敞	ihwx
敝	biwx
瑙	ncwx
敲	qnwy
裹	gowy
襄	xlwy
瑕	xxwy
袤	mcwy
袞	gywy
褻	xpwy
惠	hvxa
懦	noxa
惺	xkxa
惴	vvxa
慵	ysxa
忸	nqxa
怫	fuxa
怛	daxa
衄	nvxa
恆	hgxa
惡	wuxa
惡	eexa
愃	xrxa
憖	ybxa
憚	djxa
憚	daxa
怕	paxb
惧	juxb
忿	ffxb
愬	soxb
懶	ljxb
懶	ljxb
忖	cyxc
恃	uixc
懊	aoxd
弑	uixd
恣	zixd
惻	cexd
憑	pkxd
懣	mfxd
懺	ijxd
飄	pnxf
懼	juxf
愧	kvxg
愕	eexg
恍	hlxg
憔	qnxh
愀	qnxh
黨	dhxh
憮	wuxh
懍	lbxh
忻	xbxj
慚	cjxj
怡	yixk
恬	tmxk
惆	izxk
恪	kexk
恫	dsxk
怙	huxk
慝	texk
愴	ilxk
憺	djxk
慟	tsxl
棠	thxm
懋	mcxm
悃	kyxm
愾	xixm
愾	kdxm
慄	lixm
慍	yyxm
懈	xpxn
慷	khxn
悚	ssxn
怏	yhxn
慊	qpxn
慊	qmxn
悵	ihxn
悽	qixn
悄	qnxo
恂	xyxo
慘	cjxp
欷	xixq
怎	zfxr
恁	nfxr
愆	qmxr
慫	ssxr
憊	bwxr
戀	lmxs
恚	hvxt
慳	qmxt
當	dhxt
悍	hjxu
悴	cvxu
怦	pgxu
忤	wuxu
覃	tjxu
覃	qbxu
愨	qtxu
懌	yixu
惘	whxv
忱	ifxv
怩	nixv
悒	yixv
愍	mbxv
悗	mjxv
惓	qrxv
斃	bixv
惶	hlxw
甄	vfxw
愎	bixw
悛	qrxw
覈	huxw
覈	hexw
憫	mbxw
恤	xuxx
憬	jkxx
爻	ycxx
卍	wjxx
惱	ncxx
慓	pnxx
恙	yhxy
懷	hkxy
懾	uexy
悸	jixz
悖	bwxz
慥	zcxz
羞	xqya
裴	pwya
翡	fwya
霏	fwya
霾	mdya
薑	jlya
誦	ssya
諂	ijya
諍	vgya
諱	hvya
謔	xtya
錏	yaya
霽	jiya
靈	lkya
羶	ujya
羶	djya
諧	xpyb
讀	dzyb
讀	duyb
讚	zjyb
酣	hjyc
諞	pmyc
羹	ggyd
酊	dkyd
醴	liyd
羝	diyd
裝	vlyd
訃	fuyd
訥	neyd
詆	diyd
誂	dnyd
誂	tnyd
誡	jpyd
誨	hvyd
謨	moyd
證	vgyd
譏	jiyd
讒	ijyd
霓	niye
霍	hoyf
諷	fgyf
謗	bhyf
謠	ycyf
讎	izyf
讎	qqyf
戮	luyg
戳	ioyg
羲	xiyg
訌	hsyg
訖	qiyg
諤	eeyg
讖	ifyg
酥	suyh
醺	xyyh
燮	xpyh
詼	hvyh
讌	yjyh
諢	hyyi
霈	pwyj
觀	gryj
鯱	huyj
裔	yiyk
酩	mkyk
訶	heyk
詁	guyk
詒	yiyk
詒	ddyk
詬	gzyk
誥	gcyk
謫	veyk
謳	ouyk
譎	jtyk
醫	yiyk
勠	luyl
霖	lbym
醯	xiym
醢	hdym
諡	uiym
謐	miym
謚	uiym
譟	zcym
姜	jlyn
霎	uayn
醵	juyn
誄	lwyn
誅	vuyn
諛	yuyn
諫	jmyn
釀	nlyn
霸	bayo
霄	xnyo
醋	cuyo
詢	xyyo
誚	qnyo
諳	anyo
譖	zfyo
冑	vzyo
鰆	iyyo
醪	lcyp
訝	yayp
詛	zuyq
誣	wuyr
羚	lkys
醉	zvyu
霹	piyu
譬	piyu
謦	qiyu
霪	ybyu
襞	biyu
訐	jpyu
譚	tjyu
譯	yiyu
辯	bmyu
羌	qlyv
羯	jpyv
雹	bcyv
訛	eeyv
詭	gvyv
靂	liyv
靄	aiyv
霰	xmyw
酲	igyw
誑	klyw
謖	suyw
靉	aiyw
黴	mwyw
鱇	khyx
翔	xlyy
謾	mjyy
譫	vjyy
讓	rhyy
霆	tkyz
諄	vyyz
譴	qmyz
靆	ddyz
迪	diza
蹈	dcza
孺	ruza
踵	vsza
跚	ujza
赳	jqza
逑	qqza
逋	buza
遘	gzza
蹕	biza
躋	jiza
逕	jkza
邇	erza
邀	yczb
邃	svzb
遑	hlzb
躓	vizb
蹲	dyzc
躊	izzc
邁	mdzc
跋	bazd
迢	tnzd
蹊	xizd
蹊	qizd
遙	yczd
躑	vize
躡	npze
遨	aozf
躪	lbzf
蹉	cozg
跫	qszg
踐	jmzg
遽	juzh
逶	wwzh
躅	vuzi
邂	xpzj
逞	igzk
踞	juzk
迥	jszk
跖	vizk
踟	iizk
跏	jxzk
跼	juzk
蹌	qlzk
迴	hvzk
迴	hvzk
踴	yszl
躁	zczm
蹂	rzzm
跟	gfzn
跌	dpzn
踉	llzn
踝	hkzn
趺	fuzn
蹼	puzn
孥	nuzn
遏	eezo
躇	iuzo
暹	xmzo
趙	vczo
趁	ifzp
跛	bozp
逅	hzzp
跣	xmzp
遞	dizp
邊	bmzp
學	xtzp
迸	bgzq
蹶	jtzq
逖	tizq
遒	qqzq
孩	hdzr
逾	yuzr
蹣	pjzr
蹤	zszr
邏	lozs
逵	kvzt
躔	ijzt
遲	iizu
跪	gvzv
趾	vizv
遐	xxzv
孚	fuzv
迹	jizw
逡	qyzw
踪	zszx
逍	xnzx
迺	ndzx
跂	qizy
#other
车	ieaa
车	juaa
业	yeaa
亚	yaaa
顿	dyaa
临	lbaa
颗	keaa
丰	fgaa
韦	wwaa
颊	jxaa
鳞	lbaa
顷	qkaa
颅	luaa
韬	tcaa
鲤	liaa
麴	quaa
甭	bgaa
丌	jiaa
卣	yzaa
顸	hjaa
鲱	fwaa
芈	miaa
鳙	ysaa
艹	ccaa
鲚	jiaa
卌	xiaa
韝	gzaa
頇	hjaa
頰	jxaa
奡	aoaa
鮞	eraa
鱅	ysaa
鱭	jiaa
鲕	eraa
麵	mmaa
羋	miaa
赖	ldab
鬓	bbab
鲼	ffab
賴	ldab
鮊	boab
鮊	baab
鱝	ffab
鲌	boab
鲌	baab
皕	biab
开	kdac
鲟	xyac
鳟	zyac
鳊	bmac
鲋	fuac
鲥	uiac
鯿	bmac
鰣	uiac
鱘	xyac
两	llad
东	dsad
丽	liad
卡	kaad
卡	qxad
专	vrad
韧	rfad
枣	zcad
鲨	uaad
鱿	yzad
鳏	grad
毖	biad
鲡	liad
戋	jmad
鲅	baad
鳢	liad
內	nwad
韌	rfad
奀	nfad
奀	enad
魷	yzad
鮁	baad
归	gvae
尧	ycae
兕	siae
鳕	xtae
鲫	jiae
鲵	niae
髡	kyae
鲩	hrae
䲟	ybae
鮣	ybae
鯇	hrae
鯽	jiae
鳌	aoaf
鲛	jnaf
鳐	ycaf
鲂	fhaf
鰩	ycaf
战	vjag
戬	jmag
鳄	eeag
鹾	coag
丏	mmag
鹺	coag
戩	jmag
灭	mpah
稣	suah
鳅	qqah
鬏	jqah
穌	suah
严	yjai
虺	hvai
虿	idai
鲺	uiai
鯴	uiai
鰠	scai
鳋	scai
师	uiaj
规	gvaj
帅	ukaj
觇	ijaj
击	jiak
吞	tyak
鳝	ujak
鲇	nmak
鲷	dnak
鲒	jpak
鲐	tdak
軎	ieak
鮐	tdak
鮚	jpak
鯝	guak
鱔	ujak
鱷	eeak
鲴	guak
鳓	leal
劢	mdal
勔	mmal
鰳	leal
鱺	lial
桌	voam
橐	toam
韫	yyam
韫	wfam
鲽	dpam
髹	xqam
鲦	tnam
韞	yyam
韞	wfam
鰷	tnam
棐	fwam
夹	jxan
夹	gaan
耍	uxan
鸯	yhan
鲠	ggan
嫠	lian
伕	fuan
嫑	mqan
嫑	bcan
鯁	ggan
犛	lian
犛	mcan
鲁	luao
鳍	qiao
鲳	ihao
鲔	wwao
鲭	qkao
鬍	huao
鯧	ihao
畅	ihap
耏	ndap
耏	erap
欤	yuaq
鳜	jtaq
鳜	gvaq
鱖	jtaq
鱖	gvaq
丛	csar
鳘	mbar
鯷	tiar
鰵	mbar
鳀	tiar
鹼	jmar
紧	jbas
鲧	gyas
鲑	xpat
鲑	gvat
鲣	jmat
鲻	ziat
坒	biat
卢	luau
凿	zcau
鲈	luau
鲆	pkau
电	dmav
丝	siav
毙	biav
鲍	bcav
鲲	kyav
鬈	qrav
乩	jiav
巰	qqav
鲮	lkaw
鳆	fuaw
鳇	hlaw
鯪	lkaw
尫	whaw
鲸	jkax
卤	luax
鳖	bpax
鬃	zsax
鳃	sdax
鲶	nmax
鳔	bnax
鱉	bpax
慭	ybax
鲜	xmay
囊	nhay
翘	qnay
鳗	mjay
鲰	zzay
鳎	taay
翮	heay
䎃	rjay
鯗	xlay
鯫	zzay
鰨	taay
孬	ncaz
趸	dyaz
鲢	lmaz
鰱	lmaz
单	djba
单	ujba
单	ijba
贵	gvba
额	eeba
丫	yaba
审	ufba
疗	lnba
贤	xmba
窜	crba
页	yeba
贞	vfba
颁	bjba
颂	ssba
癫	dmba
痹	biba
贮	vuba
甯	nkba
疟	ycba
疟	ntba
痈	ysba
痱	fwba
鲞	xlba
赉	ldba
瘅	djba
痄	vaba
癃	lsba
痖	yaba
宧	yiba
瘂	yaba
癉	djba
赛	sdbb
贫	pbbb
宾	bbbb
癞	ldbb
癀	hlbb
赑	bibb
赙	fubc
贳	uibc
癟	bpbc
实	uibd
资	zibd
负	fubd
宁	nkbd
窝	wobd
赋	fubd
赎	uubd
窦	dzbd
宓	mibd
宓	fubd
瘀	yubd
瘌	labd
甯	nkbd
穸	xibd
瘼	mobd
窬	yubd
赆	jbbd
賕	qqbd
赇	qqbd
寬	krbd
宪	xmbe
兑	dvbe
贶	klbe
疖	jpbe
貺	klbe
冚	kjbe
癤	jpbe
责	zebf
疯	fgbf
瘫	tjbf
窑	ycbf
赘	vvbf
贽	vibf
癯	qubf
癱	tjbf
贡	gsbg
贱	jmbg
窍	qnbg
疙	gebg
痉	jkbg
窳	yubg
瘥	idbg
瘥	cdbg
戭	yjbg
㿠	hlbg
灾	zdbh
賧	djbh
赕	djbh
军	jybi
瘙	scbi
宽	krbj
帘	lmbj
窥	kvbj
幂	mibj
宄	gvbj
员	yrbk
宫	gsbk
兽	uzbk
贴	tpbk
赔	pwbk
瘩	dabk
赂	lubk
贻	yibk
疴	kebk
痦	wubk
賙	vzbk
賙	vzbk
赒	vzbk
穷	qsbl
贺	hebl
宠	isbl
痨	lcbl
疬	libl
骞	qmbm
痫	xmbm
桊	jrbm
冧	lfbm
寀	cdbm
赞	zjbn
赚	vrbn
赚	zjbn
账	vhbn
贬	bmbn
痪	hrbn
赈	vfbn
瘐	yubn
瘿	ykbn
窠	kebn
瘘	lzbn
窭	jubn
冁	ijbn
窆	bmbn
瘃	vubn
賬	vhbn
瘓	hrbn
癭	ykbn
赌	dubo
赠	zgbo
贿	hvbo
窨	ybbo
窨	xybo
财	cdbp
贸	mcbp
赐	cibp
疡	yhbp
皲	jybp
疠	libp
瘳	izbp
痧	uabp
皂	zcbq
货	hobr
贪	tjbr
贷	ddbr
瘸	qtbr
赁	lbbr
赅	gdbr
賅	gdbr
寁	zjbr
购	gzbs
赃	zhbt
痤	cobt
皤	pobt
瘗	yibt
瘞	yibt
贼	zwbu
掰	bdbu
贲	bibu
贲	bfbu
赍	jibu
瘊	hzbu
屃	xibu
皁	zcbu
窣	subu
费	fwbv
贯	grbv
疤	babv
疮	ilbv
瘪	bpbv
皑	aibv
赀	zibv
窀	vybv
宬	igbv
癍	bjbw
疰	vubw
攽	bjbw
瓫	pgbw
痠	srbw
癥	vgbw
赏	uhbx
贾	jxbx
贾	gubx
瘾	ybbx
赊	uebx
癔	yibx
瘵	vdbx
瘛	iibx
賒	uebx
瘭	bnbx
癮	ybbx
瘦	uzby
贩	fjby
翱	aoby
赡	ujby
誊	tgby
癣	xrby
褰	qmby
瘕	xxby
瘕	jxby
䎖	zgby
萧	xnca
苇	wwca
苯	bfca
堇	jbca
颧	qrca
蕤	rvca
荞	qnca
荠	qica
荠	jica
苎	vuca
蘼	mica
萏	djca
蕺	jica
蓣	yuca
颟	mjca
苤	ppca
薷	ruca
莶	xmca
莶	lmca
茀	fuca
茽	vsca
荁	hrca
萚	toca
蓽	bica
顢	mjca
萁	qicb
蒉	kvcb
蒉	kkcb
蒇	ijcb
蕻	hscb
茓	xtcb
葓	hscb
蒈	kdcb
蓂	mkcb
蕆	ijcb
蕒	mdcb
蕢	kvcb
蕢	kkcb
藠	jncb
黃	hlcb
莳	uicc
薅	hccc
苷	gjcc
荨	xycc
荨	qmcc
葑	fgcc
荓	pkcc
荮	vzcc
萹	bmcc
葤	vzcc
蔣	jlcc
药	yccd
苏	sucd
萝	locd
蘅	hgcd
蓟	jicd
荥	ykcd
荥	xkcd
莆	pucd
荇	xkcd
菸	yjcd
荩	jbcd
茇	bacd
莴	wocd
芄	wjcd
菝	bacd
莸	yzcd
葶	tkcd
苄	bmcd
葜	qxcd
荬	mdcd
芃	pgcd
茋	vicd
莿	cicd
菂	dicd
菉	lucd
薁	yucd
薴	vucd
薴	nkcd
节	jpce
荛	rcce
茺	isce
蔸	dzce
苉	pice
茚	ybce
䓛	quce
䓛	guce
䓛	fuce
薌	xlce
蔺	lbcf
萑	hrcf
茭	jncf
藿	hocf
蕹	wgcf
蒱	pucf
䓨	ykcf
蘺	licf
艺	yicg
芎	xscg
荭	hscg
茳	jlcg
葒	hscg
葴	vfcg
蓏	locg
藭	qscg
薰	xych
荧	ykch
蔫	nmch
蘸	vjch
菼	tjch
藨	pcch
藨	bnch
𦼖	lmch
萨	saci
萤	ykci
茧	jmci
荤	hyci
蔃	qlci
蠆	idci
苋	xmcj
觐	jbcj
蕲	qicj
芾	fwcj
芾	fucj
蓥	ykcj
艽	qqcj
艽	jncj
菥	xicj
莧	xmcj
蘄	qicj
觏	gzcj
营	ykck
蔷	qlck
蓓	bwck
菇	guck
菡	hjck
茁	vock
莒	juck
苕	ucck
苕	tnck
菏	heck
茼	tsck
萜	tpck
苘	qkck
茝	idck
莙	jyck
䓫	qick
劳	lccl
荔	licl
茏	lscl
苈	licl
葧	bocl
蒞	licl
䓖	qscl
勚	yicl
勩	yicl
勱	mdcl
蓝	ljcm
荣	rscm
蓦	mocm
蕴	yycm
蕖	qucm
芼	mccm
蕰	yycm
藎	jbcm
棻	ffcm
莺	ykcn
荦	locn
葳	wwcn
荑	yicn
荑	ticn
荚	jxcn
苌	ihcn
芨	jicn
茑	nncn
蒌	lzcn
荽	svcn
茛	gfcn
蒎	pdcn
萊	ldcn
蒗	lhcn
蔞	lzcn
薢	xpcn
荫	ybco
瞢	mgco
蒴	uoco
葙	xlco
蒨	qmco
蓇	guco
蓢	lhco
荡	dhcp
芴	wucp
芴	hucp
艿	ndcp
芗	xlcp
苾	bicp
荖	lccp
获	hocq
芪	qicq
莰	kjcq
蔌	sucq
芡	qmcq
菹	zucq
甙	ddcq
苠	mbcq
葖	tucq
芮	rvcr
苁	cscr
蓰	xicr
荄	gdcr
萣	dkcr
蓯	cscr
薟	xmcr
薟	lmcr
薿	nicr
萦	ykcs
荟	hvcs
蓠	lics
蘩	fjcs
蓀	sycs
蕓	yycs
蕓	yycs
茬	iact
茔	ykct
芏	duct
莝	coct
藟	lwct
芊	qmcu
蘑	mocu
摹	mocu
蒺	jicu
莘	xbcu
莘	ufcu
茕	qscu
荜	bicu
茌	iicu
莛	tkcu
菪	dhcu
萆	bicu
萳	njcu
䓬	vocu
蔊	hjcu
藦	mocu
蘀	tocu
斠	jncu
苍	chcv
芷	vicv
蔼	aicv
芜	wucv
芩	qbcv
菀	yycv
菀	wjcv
茈	zicv
茈	cicv
芑	qicv
葚	ufcv
芘	picv
芘	bicv
莼	iycv
芤	kzcv
苊	eecv
藶	licv
莹	ykcw
荃	qrcw
莜	yzcw
芠	wfcw
葰	jycw
蔹	lmcw
蘞	lmcw
蕙	hvcx
荪	sycx
萘	ndcx
葸	xicx
薏	yicx
蒽	encx
芣	fucx
菍	rfcx
菍	npcx
蔈	bncx
蔥	cscx
薸	pncx
蔻	kzcy
藓	xmcy
菔	fucy
芰	jicy
蕞	zvcy
蘘	rhcy
莲	lmcz
孽	npcz
蘧	qucz
莩	fucz
荸	bicz
荙	dacz
薘	dacz
薳	yrcz
薳	wwcz
躉	dycz
顶	dkda
济	jida
鱼	yuda
泽	zeda
净	jkda
渔	yuda
潇	xnda
泻	xpda
濒	bbda
渲	xrda
殛	jida
殓	lmda
灏	hcda
殚	djda
洹	hrda
瀣	xpda
滹	huda
澶	ijda
泮	pjda
洚	jlda
渖	ufda
滏	fuda
氵	uvda
淠	pwda
淠	pida
濞	pida
濞	bida
涠	wwda
剅	lzda
剕	fwda
夼	klda
殭	jlda
汈	dnda
汫	jkda
潷	bida
潿	wwda
澦	yuda
灝	hcda
灝	hcda
则	zedb
溃	kvdb
滨	bbdb
渍	zidb
濑	lddb
殒	yydb
滇	dmdb
殡	bbdb
潢	hldb
潢	gldb
剜	wjdb
浈	vfdb
瀵	ffdb
奭	uidb
涢	yydb
湞	vfdb
溳	yydb
滪	yudb
瀆	dudb
瀨	lddb
夺	dodc
荆	jkdc
蒯	kkdc
澍	uudc
澍	vudc
浔	xydc
漭	mhdc
泔	gjdc
瀹	ytdc
劐	hodc
剒	codc
汧	qmdc
洴	pkdc
㽏	gjdc
头	tzdd
满	mjdd
测	cedd
奖	jldd
凑	czdd
冻	dsdd
泼	podd
澜	ljdd
浆	jldd
浏	lqdd
渎	dudd
淼	mndd
汴	bmdd
泞	nkdd
涮	urdd
沏	qidd
澧	lidd
洮	tcdd
洇	ybdd
沭	uudd
渌	ludd
汊	iadd
泺	lodd
湔	jmdd
沩	wwdd
剦	yjdd
奓	vadd
奓	uedd
奓	iidd
毚	ijdd
汋	vodd
汋	qtdd
汍	wjdd
汭	rvdd
沊	djdd
淥	ludd
灃	fgdd
㳚	yudd
浇	jnde
耷	dade
沅	yrde
洱	erde
刍	iude
泖	mcde
冼	xmde
剀	kdde
刿	gvde
奅	pcde
沇	yjde
灄	uede
㓥	thde
㳘	isde
滩	tjdf
雏	iudf
沣	fgdf
潍	wwdf
濉	svdf
殣	jbdf
渢	fgdf
滻	ijdf
濰	wwdf
灕	lidf
门	mfdg
划	hxdg
污	wudg
溅	jmdg
刨	pcdg
刨	bcdg
泾	jkdg
汔	qidg
豇	jldg
冮	ghdg
刬	ijdg
剗	ijdg
氹	tfdg
氹	dhdg
涇	jkdg
涂	tudh
沪	hudh
沪	lvdh
滁	iudh
剡	yjdh
剡	ujdh
溱	vfdh
溱	qbdh
溈	wwdh
滎	ykdh
滎	xkdh
潙	wwdh
浑	hydi
浊	vodi
劂	jtdi
浐	ijdi
沉	ifdj
渐	jmdj
剁	dodj
钊	vcdj
沆	hhdj
浠	xidj
澌	sidj
釗	vcdj
凘	sidj
氿	jqdj
氿	gvdj
浉	uidj
溮	uidj
灠	ljdj
别	bpdk
刚	ghdk
减	jmdk
洁	jpdk
汇	hvdk
汹	xsdk
漪	yidk
潞	ludk
剐	gxdk
涪	fudk
洄	hvdk
涫	grdk
浯	wudk
剮	gxdk
呇	qidk
夠	gzdk
泂	jsdk
泃	judk
泇	jxdk
浛	hjdk
湉	tmdk
漚	oudk
沥	lidl
涝	lcdl
夯	hhdl
泷	uldl
泷	lsdl
泐	ledl
剷	ijdl
澇	lcdl
冯	pkdm
冯	fgdm
滥	ljdm
涤	didm
溧	lidm
滦	lrdm
湓	pfdm
滗	bidm
凓	lidm
溫	wfdm
濼	lodm
灤	lrdm
灩	yjdm
农	nsdn
浓	nsdn
牵	qmdn
鸿	hsdn
涨	vhdn
妆	vldn
涣	hrdn
奂	hrdn
浃	jxdn
涿	vodn
涞	lddn
涑	sudn
漤	ljdn
沬	mwdn
淶	lddn
涧	jmdo
湄	mwdo
汩	yudo
汩	gudo
灞	bado
刖	ytdo
洧	wwdo
潲	ucdo
洎	jido
澮	kkdo
澮	hvdo
皱	vzdp
汤	thdp
涉	uedp
渗	ufdp
删	ujdp
殇	uhdp
劓	yidp
沘	bidp
澩	xtdp
殂	cudq
溴	xqdq
洑	fudq
淚	lwdq
狀	vldq
㵐	jtdq
剑	jmdr
创	ildr
涡	wodr
涡	godr
漩	xrdr
刽	gvdr
劁	qndr
劊	gvdr
殮	lmdr
湜	uidr
沟	gzds
泠	lkds
泫	xrds
潆	ykds
漯	tads
漯	lwds
漯	lods
凇	ssds
浍	kkds
浍	hvds
沄	yyds
瀠	ykds
奋	ffdt
洼	wadt
淄	zidt
𠝹	jpdt
溼	uidt
瀍	ijdt
户	hudu
剧	judu
歼	jmdu
汛	xydu
漳	vhdu
浒	xudu
浒	hudu
泸	ludu
淖	vodu
淖	ncdu
淖	iodu
汙	wudu
㓤	jidu
渴	kedv
涩	sedv
龟	qqdv
龟	jydv
龟	gvdv
沧	chdv
沦	lydv
涔	cfdv
汜	sidv
溉	gddv
滟	yjdv
沔	mmdv
刭	jkdv
渑	ugdv
渑	mmdv
淝	fwdv
沲	dodv
浼	mwdv
剝	bodv
剝	bcdv
劄	vadv
劌	gvdv
浥	yidv
澠	ugdv
澠	mmdv
灧	yjdv
刘	lqdw
润	rydw
剂	jidw
澈	iedw
滢	ykdw
玺	xidw
潋	lmdw
汶	wfdw
汶	mfdw
澉	gjdw
淩	lkdw
漵	xudw
瀅	ykdw
尔	erdx
沪	hudx
沪	lvdx
滤	lvdx
奁	lmdx
沤	oudx
漶	hrdx
剎	uadx
剎	iadx
劏	thdx
劏	tsdx
沨	fgdx
淴	hudx
㓥	thdx
㳇	fudx
㴔	yidx
㴔	sedx
汉	hjdy
滚	gydy
詹	vjdy
殁	mody
豉	iidy
溻	tady
溆	xudy
滠	uedy
剟	dody
潑	pody
涟	lmdz
浞	vodz
	dadz
澾	dadz
㳠	dadz
卫	wwea
险	xmea
阶	jpea
顽	wjea
邮	yzea
阱	jkea
邢	xkea
巅	dmea
屿	yuea
峥	vgea
邺	yeea
郦	viea
郦	liea
鄢	yjea
嶙	lbea
颛	vrea
聃	djea
郏	jxea
邳	piea
邴	bkea
峄	yiea
峤	qnea
峤	jnea
邗	hjea
亍	iuea
豳	bbea
邶	bwea
郅	viea
颞	npea
亓	qiea
阼	zoea
耑	drea
郟	jxea
鄴	yeea
酈	viea
酈	liea
顓	vrea
岞	zoea
峘	hrea
崄	xmea
嵖	iaea
巔	dmea
职	vieb
陨	yyeb
郸	djeb
聩	kveb
郓	yyeb
聵	kveb
邠	bbeb
鄆	yyeb
嶍	xieb
寻	xyec
鄞	ybec
岍	qmec
䢼	gsec
崶	fgec
嶟	zyec
联	lmed
陈	ifed
岁	sved
邹	zzed
嵛	yued
岽	dsed
聍	nked
耵	dked
聤	tked
卲	uced
隩	yued
隩	aoed
峂	tsed
峛	lied
㠇	jqed
酆	fgee
岿	kvee
峁	mcee
鄹	zzee
阢	wwee
阢	wuee
䢺	iuee
屼	wuee
屾	ufee
峣	ycee
岚	ljef
邡	fhef
聱	aoef
峧	jnef
亏	kveg
崆	kseg
邝	kleg
郇	xyeg
郇	hreg
陉	xkeg
邛	qseg
鄺	kleg
陘	xkeg
隉	npeg
嵅	hjeg
嶲	xieg
嶲	jreg
嶲	gveg
巇	xieg
灵	lkeh
郯	tjeh
阵	vfei
崒	zuei
崒	cvei
凯	kdej
崭	vjej
觊	jiej
岘	xmej
峴	xmej
巋	kvej
陆	luek
陆	lqek
峒	tsek
峒	dsek
郧	yyek
岢	keek
郾	yjek
崮	guek
岣	gzek
岵	huek
阽	dmek
鄖	yyek
喐	yuek
岠	juek
峿	wuek
崌	juek
崡	hjek
嶠	qnek
嶠	jnek
嶦	vjek
嶦	ujek
㞹	keek
㟃	siek
动	dsel
陇	lsel
崂	lcel
鄣	vhel
嶗	lcel
嵘	rsem
粜	tnem
嵲	npem
嶸	rsem
櫱	npem
陕	ujen
崴	wwen
崴	wden
郜	gcen
嵊	ugen
崃	lden
嵝	lzen
崾	ycen
崀	lhen
崍	lden
崬	dsen
嶁	lzen
㠓	mgen
阳	yheo
阴	ybeo
峋	xyeo
崤	xneo
嵴	jieo
嶒	cgeo
邬	wuep
鄱	poep
岈	yaep
邾	vuep
郫	piep
鄔	wuep
卬	yhep
卬	ahep
嶨	xtep
郑	vgeq
崁	kjeq
嵚	qbeq
嶔	qbeq
队	dver
耸	sser
陡	dzer
邻	lber
郐	kker
郐	gver
陔	gder
郃	heer
鄶	kker
鄶	gver
岭	lkes
崧	sses
邰	tdes
嵫	zies
郝	hcet
陧	npet
嶓	boet
陴	pieu
嶧	yieu
岂	qiev
鼋	yrev
崦	yjev
屺	qiev
岜	baev
郿	mwev
鄉	xlev
鄧	dgev
峗	wwev
崿	eeev
嵁	vjev
嵁	kjev
黿	yrev
邙	mhew
隐	ybex
际	jiex
聪	csex
岗	ghex
岖	quex
郗	xiex
鄄	jrex
隳	hvex
隳	doex
郄	qpex
郄	xiex
䣘	thex
邓	dgey
聂	npey
酃	lkey
鄯	ujey
鼗	tcey
叆	aiey
彟	hoey
彠	hoey
崞	goez
叇	ddez
拥	ysfa
择	vdfa
择	zefa
扭	nqfa
挣	vgfa
挤	jifa
捡	jmfa
掐	qxfa
捅	tsfa
掸	ujfa
掸	djfa
撺	crfa
撷	xpfa
擤	xkfa
揎	xrfa
揸	vafa
挢	jnfa
拃	vafa
掙	vgfa
搣	mpfa
搣	mifa
摏	isfa
摑	gofa
撣	ujfa
撣	djfa
擷	xpfa
损	syfb
扒	pafb
扒	bafb
攒	zjfb
攒	crfb
飓	jufb
罂	ykfb
掼	grfb
摈	bbfb
捵	dmfb
捵	nmfb
摜	grfb
攢	zjfb
攢	crfb
㨢	bofb
拼	pbfc
拚	pbfc
捋	lvfc
捋	lofc
摒	bkfc
撙	zyfc
挦	xmfc
掄	lyfc
撏	xmfc
扑	pufd
执	vifd
爹	dpfd
扰	rcfd
拨	bofd
揍	zzfd
拧	nkfd
拣	jmfd
搀	ijfd
抟	trfd
拤	qxfd
捯	dcfd
揳	xpfd
揼	dyfd
揼	djfd
擰	nkfd
攙	ijfd
旐	vcfd
㧑	wwfd
爷	yefe
挡	dhfe
扫	scfe
挪	nofe
掷	vife
捣	dcfe
挠	ncfe
嶅	aofe
抌	vffe
搊	izfe
摇	ycff
摊	tjff
攉	hoff
搒	pgff
搒	bhff
扩	kofg
挖	wafg
挎	kxfg
搲	wafg
护	hufh
揪	jqfh
飚	bnfh
摭	vifh
搋	ikfh
飈	bnfh
掞	yjfh
掞	ujfh
撝	wwfh
罃	ykfh
挥	hvfi
搔	scfi
撵	nmfi
攆	nmfi
带	ddfj
搅	jnfj
揽	ljfj
靓	llfj
靓	jkfj
靚	llfj
靚	jkfj
搞	gcfk
捂	wufk
搁	gefk
掂	dmfk
旖	yifk
撂	lnfk
搪	thfk
掊	pzfk
捃	jyfk
颳	gxfk
摳	kzfk
撟	jnfk
撾	wofk
撾	vxfk
擓	kkfk
㧟	kkfk
拢	lsfl
捞	lcfl
掳	lufl
拋	pcfl
擄	lufl
攏	lsfl
捆	kyfm
撬	qnfm
搡	shfm
扪	mffm
搽	iafm
揲	uefm
豔	yjfm
掹	mgfm
揾	wffm
搵	wffm
擝	mgfm
换	hrfn
搂	lzfn
撄	ykfn
揠	yafn
搛	jmfn
搌	vjfn
摟	lzfn
攔	ljfn
攖	ykfn
捎	ucfo
撸	lufo
搠	uofo
掮	qmfo
揞	yjfo
揞	yefo
揞	anfo
掤	bffo
揗	uyfo
揹	bwfo
揹	bwfo
擼	lufo
㨘	xkfo
扬	yhfp
扔	rgfp
拽	vkfp
掺	xmfp
掺	ujfp
掺	ijfp
颺	yhfp
飏	yhfp
摻	xmfp
摻	ujfp
摻	ijfp
撐	igfp
抿	mbfq
撅	jtfq
揿	qbfq
扺	vifq
挓	vafq
撳	qbfq
拟	nifr
靛	dmfr
抦	bkfr
撿	jmfr
摆	bdfs
拦	ljfs
拎	lbfs
攥	zrfs
摞	lofs
摛	iifs
搐	iuft
捱	aift
擋	dhft
撑	igfu
摔	ukfu
捱	aifu
抨	pgfu
罄	qkfu
捭	bdfu
擀	gjfu
扦	qmfu
擗	pifu
砉	xufu
砉	hxfu
䂮	ltfu
捽	zofu
撢	djfu
攛	crfu
㩧	bofu
罈	tjfu
抢	qlfv
抢	igfv
爸	bafv
抚	fufv
拖	tofv
艳	yjfv
扯	iefv
揭	qifv
揭	jpfv
抡	lyfv
旎	nifv
挹	yifv
飑	bnfv
颮	bnfv
扽	dffv
揕	vffv
摴	iufv
撇	ppfw
拴	urfw
拄	vufw
擞	szfw
撖	hjfw
抆	mffw
抆	wffw
擻	szfw
摁	enfx
抠	kzfx
掭	tmfx
摅	uufx
摽	bnfx
攄	uufx
㩒	qbfx
报	bcfy
摄	uefy
摄	npfy
扳	bjfy
飕	szfy
掇	dofy
攮	nhfy
擐	hrfy
颼	szfy
擭	hofy
㧐	ssfy
㩳	ssfy
挞	tafz
挝	wofz
挝	vxfz
擿	vifz
擿	vdfz
擿	tifz
旞	svfz
㨃	igfz
㨃	dvfz
应	ykga
项	xlga
习	xiga
弹	tjga
弹	djga
庙	mnga
刁	dnga
匀	yyga
鞒	qnga
廑	jbga
廑	qbga
鞲	gzga
骱	jpga
勻	yyga
庼	qkga
廎	qkga
⺕	jiga
赓	gggb
髌	bbgb
賡	gggb
髕	bbgb
髒	zhgc
庤	vigc
廙	yigc
够	gzgd
庆	qkgd
废	fwgd
巩	gsgd
魉	llgd
骶	digd
髖	krgd
弪	jkgg
戤	gdgg
骻	kxgg
魆	xugg
廆	wwgg
廆	hvgg
廆	gvgg
弳	jkgg
庐	lugh
韉	jmgh
强	qlgi
强	jlgi
库	kugi
辉	hvgi
䗪	vegi
靳	jbgj
髋	krgj
骷	kugk
髂	qxgk
骺	hzgk
鞀	tcgk
鞽	qngk
弨	icgk
庞	phgl
龐	phgl
庥	xqgm
张	vhgn
鹰	ykgn
髅	lzgn
庹	togn
庾	yugn
髁	kegn
瓞	dpgn
魈	xngo
麽	mogs
厾	dugs
廕	ybgs
庳	bwgu
靶	bagv
乜	npgv
乜	mpgv
鼐	ndgv
庑	wugv
庀	pigv
鞔	mjgv
鞔	mfgv
㐖	jigv
廒	aogw
庱	iggw
廪	lbgx
尕	gagx
弶	jlgx
彆	bpgx
訇	hsgy
庋	gvgy
廄	jqgy
廋	szgy
弢	tcgy
鞑	dagz
鞯	jmgz
鞬	jmgz
种	vsha
种	isha
黑	hwha
烦	fjha
焰	yjha
颓	tvha
炜	wwha
煊	xrha
烀	huha
虛	xuha
頹	tvha
烜	xrha
煒	wwha
燁	yeha
㶲	ysha
㸆	kcha
㸌	hoha
积	jihb
炽	iihb
熠	yihb
烘	hshb
稹	vfhb
煸	bmhc
爝	jthc
炼	lmhd
煞	uahd
烁	uohd
烫	thhd
秽	hvhd
烬	jbhd
黩	duhd
黟	yihd
菸	yjhd
秫	uuhd
扅	yihd
燙	thhd
烧	uche
灿	cjhe
嵇	jihe
烷	wjhe
稅	uvhe
热	rehf
焘	tchf
焘	dchf
爟	grhf
缹	fzhf
烤	kchg
烃	tkhg
戱	xihg
烴	tkhg
焱	yjhh
黧	lihh
扊	yjhh
熒	ykhh
㷫	hkhh
烛	vuhi
秃	tuhj
觑	quhj
炕	khhj
烯	xihj
虤	yjhj
覷	quhj
启	qihk
秸	jphk
焓	hjhk
穑	sehk
熵	uhhk
焐	wuhk
扃	jshk
扂	dmhk
烚	xxhk
焗	juhk
熗	qlhk
稆	lvhk
稖	pwhk
虏	luhl
煜	yuhl
棨	qihm
檾	qkhm
燊	ufhm
焕	hrhn
煨	wwhn
炔	qthn
稞	kehn
稂	lhhn
燶	nshn
秾	nshn
穠	nshn
㶶	nshn
煳	huho
燴	hvho
穭	lvho
穭	lvho
㬎	xmho
炀	yhhp
秭	zihp
黪	cjhp
䅟	cjhp
黲	cjhp
	cjhp
穇	cjhp
戾	lihq
欻	xuhq
欻	ixhq
煲	bchr
烂	ljhs
炫	xrhs
烩	hvhs
罴	pihs
縈	ykhs
灶	zcht
熘	lqht
烨	yehu
焊	hjhu
秆	gjhu
炻	uihu
焯	vohu
焯	ichu
戽	huhu
焠	cvhu
燾	tchu
燾	dchu
炖	dyhv
炝	qlhv
炷	vuhw
黢	quhw
炆	wfhw
焌	quhw
焌	jyhw
稳	wfhx
虑	lvhx
焖	mfhx
燜	mfhx
繐	svhx
煅	drhy
烊	yhhy
熳	mjhy
扆	yihy
煆	xxhy
煺	tvhz
稃	fuhz
顾	guia
辈	bwia
轿	jnia
轴	vzia
靥	yeia
辇	nmia
蚱	vaia
蛐	quia
蚺	rjia
辚	lbia
厣	yjia
蚧	jpia
蛴	qiia
虯	qqia
蟈	goia
蟏	xnia
蟬	ijia
蠐	qiia
蠨	xnia
軤	huia
轔	lbia
轷	huia
厴	yjia
砵	boia
赝	yjib
蟥	hlib
蜞	qiib
轵	viib
贗	yjib
軹	viib
蠛	mpic
转	vrid
压	yaid
厅	tkid
输	uuid
辆	llid
辅	fuid
蚁	yiid
厕	siid
厕	ceid
虾	xxid
轼	uiid
螭	iiid
蜗	woid
龋	quid
辏	czid
轫	rfid
螨	mjid
轹	liid
蝲	laid
蟣	jiid
軔	rfid
軚	tdid
厲	liid
辑	jiie
蜕	tvie
蛲	ncie
较	jnif
蛰	veif
螃	phif
蜇	veif
蚄	fhif
蚄	bhif
轻	qkig
载	zdig
魇	yjig
虼	geig
齕	heig
龁	heig
螓	qbih
厍	ueii
蠋	vuii
厙	ueii
斩	vjij
轨	gvij
蚬	xmij
蛳	siij
虮	jiij
䗖	diij
䗛	xqij
䜣	ybij
䜣	xiij
䜣	xbij
螄	siij
螮	diij
訢	ybij
訢	xiij
訢	xbij
辖	xxik
轲	keik
蜮	yuik
辂	luik
轱	guik
龉	yuik
蟮	ujik
蚵	eeik
龆	tnik
轺	ycik
螗	thik
蝘	yjik
軲	guik
軺	ycik
历	liil
辘	luil
蚴	yzil
蜐	jpil
蚂	maim
蝾	rsim
蜢	mgim
蚝	hcim
螞	maim
螠	yiim
辗	vjin
辗	nmin
辗	zjin
蝼	lzin
轶	yiin
蚨	fuin
龈	ybin
龈	kfin
蛑	mzin
蛱	jxin
蠓	mgin
蠊	lmin
蟓	xlin
蜾	goin
蛺	jxin
蠔	hcin
蠔	hcin
厢	xlio
蜡	laio
厝	coio
蝽	iyio
螬	ccio
蜎	yrio
蜰	xpio
曆	liio
礵	ulio
厉	liip
轸	vfip
蚜	yaip
蟛	pgip
软	rriq
厌	yjiq
龃	juiq
蛃	bkir
蟎	mjir
龄	lkis
蝥	mcis
辎	ziit
辐	fuit
龌	woit
轾	viit
蝰	kvit
蛏	igit
轩	xriu
蟑	vhiu
蜓	tkiu
轳	luiu
餍	yjiu
蝻	njiu
蜱	piiu
虷	hjiu
蚲	pkiu
蟫	ybiu
蟫	xyiu
饜	yjiu
轮	lyiv
蝇	ykiv
虬	qqiv
辄	veiv
轧	yaiv
轧	vaiv
轧	gaiv
龇	ziiv
龅	bciv
蚍	piiv
辊	gyiv
蜣	qliv
轭	eeiv
龀	ifiv
辋	whiv
蚆	baiv
蠟	laiv
輞	whiv
輥	gyiv
齙	bciv
齜	ziiv
歷	liiv
辙	veiw
蝈	goiw
蛀	vuiw
輇	qriw
辁	qriw
螈	yrix
螅	xiix
蟪	hvix
螵	pnix
轰	hsiy
辕	yriy
辍	ioiy
蠼	quiy
蝤	qqiy
蛘	yhiy
螋	sziy
龊	ioiz
䗴	tkiz
虸	ziiz
餸	ssiz
钟	vsja
鉴	jmja
尬	gaja
览	ljja
锤	ivja
铮	vgja
钮	nqja
钵	boja
铎	doja
锺	vsja
颀	qija
钏	irja
钜	juja
铀	yzja
镛	ysja
钨	wuja
帏	wwja
钾	jxja
觯	vija
锂	lija
钽	tjja
锸	iaja
钌	lnja
镉	geja
镩	crja
觶	vija
釕	lnja
鈡	vsja
鈾	yzja
鉀	jxja
鉭	tjja
鋰	lija
鍤	iaja
鎅	gdja
鎘	geja
鏞	ysja
鏵	hxja
鏽	xqja
頎	qija
镇	vfjb
锁	sojb
帕	pajb
帜	vijb
镔	bbjb
帧	vfjb
锴	kdjb
铂	bojb
钡	bwjb
帻	zejb
镄	fwjb
鉑	bojb
鋇	bwjb
鍇	kdjb
鐨	fwjb
鑌	bbjb
幘	zejb
铸	vujc
锵	qljc
钳	qmjc
锝	dejc
锛	bfjc
锊	ltjc
帱	izjc
帱	dcjc
帱	czjc
锎	kdjc
鋝	ltjc
錛	bfjc
鍀	dejc
鐦	kdjc
帡	pkjc
幬	izjc
幬	dcjc
幬	czjc
铺	pujd
钉	dkjd
锅	gojd
钧	jyjd
钓	dnjd
锣	lojd
钗	idjd
钛	tdjd
钹	bojd
钺	ytjd
钠	najd
铄	uojd
锲	qpjd
鎏	lqjd
镫	dgjd
铡	vajd
镁	mwjd
铉	xrjd
鋈	wujd
镆	mojd
钚	bujd
铟	ybjd
镧	ljjd
钒	fjjd
尥	lnjd
钋	pojd
锇	eejd
铫	ycjd
铫	tnjd
铫	dnjd
䥽	pojd
釙	pojd
釩	fjjd
鈈	bujd
鈉	najd
鈦	tdjd
鈸	bojd
銦	ybjd
鋂	mwjd
鋨	eejd
鍘	vajd
鍥	qpjd
鎂	mwjd
鏌	mojd
鑭	ljjd
镜	jkje
锐	rvje
铛	igje
铛	dhje
铳	isje
铣	xmje
铣	xije
觥	gsje
铆	mcje
铙	ncje
铒	erje
铘	yeje
鉺	erje
銳	rvje
鋣	yeje
鎲	thje
镋	thje
帨	uvje
帮	bhjf
锋	fgjf
锥	vvjf
镑	bhjf
鏊	aojf
铰	jnjf
钫	fhjf
鈁	fhjf
鉸	jnjf
鎊	bhjf
鏟	ijjf
鏟	ijjf
钱	qmjg
铐	kcjg
锷	eejg
钙	gdjg
銎	qsjg
钇	yijg
釔	yijg
鈣	gdjg
銬	kcjg
锹	qnjh
镳	bnjh
钬	hojh
锬	tjjh
鈥	hojh
錟	tjjh
鎢	wujh
鎣	ykjh
鑣	bnjh
钂	thjh
铲	ijji
镯	voji
錾	zjji
镪	qlji
鏹	qlji
鐲	voji
斶	iuji
锦	jbjj
鑫	xbjj
钪	khjj
钸	bujj
铈	uijj
铞	dnjj
虓	xnjj
鈧	khjj
鈰	uijj
鈽	bujj
銱	dnjj
钻	zrjk
铜	tsjk
铭	mkjk
铅	qmjk
锯	jujk
锢	gujk
铝	lvjk
镐	hcjk
镐	gcjk
镝	dijk
钴	gujk
铬	gejk
锕	aajk
锆	gcjk
锘	nojk
铪	kejk
铪	hajk
锔	jujk
铷	rujk
钶	kejk
钷	pojk
锫	pwjk
鈳	kejk
鉆	zrjk
鉕	pojk
鉻	gejk
鉿	kejk
鉿	hajk
銣	rujk
鋁	lvjk
鋦	jujk
鋯	gcjk
錇	pwjk
錒	aajk
鍩	nojk
铦	xmjk
铦	tmjk
铦	gxjk
镕	rsjk
锄	iujl
铹	lcjl
鐒	lcjl
杂	zajm
朵	dojm
尴	gjjm
铩	uajm
铢	vujm
锰	mgjm
镍	npjm
镒	yijm
钔	mfjm
錳	mgjm
鍆	mfjm
鎳	npjm
铁	tpjn
银	ybjn
帐	vhjn
镰	lmjn
镂	lzjn
锒	lhjn
锞	kejn
铗	jxjn
幞	fujn
觫	sujn
铵	anjn
觖	jtjn
钕	nvjn
镓	jxjn
镤	pujn
铼	ldjn
襆	fujn
釹	nvjn
銨	anjn
鋃	lhjn
錁	kejn
錸	ldjn
鍊	lmjn
鎵	jxjn
鏷	pujn
鐮	lmjn
幪	mgjn
错	cojo
销	xnjo
钥	ytjo
钥	ycjo
锏	jmjo
旮	gajo
锗	vejo
钼	mujo
镅	mwjo
锖	qljo
镨	pujo
铕	yzjo
镥	lujo
䦃	vojo
鈅	ytjo
鈅	ycjo
鉬	mujo
銪	yzjo
錩	ihjo
鍺	vejo
鎇	mwjo
鐗	jmjo
鐠	pujo
鐧	jmjo
鐯	vojo
鑥	lujo
锠	ihjo
锡	xijp
钞	icjp
锈	xqjp
镌	jrjp
觞	uhjp
帔	pwjp
锑	tijp
铋	bijp
铴	thjp
铍	pijp
钐	ujjp
䥺	yajp
釤	ujjp
釾	yajp
鈹	pijp
鉍	bijp
銻	tijp
鍚	xijp
鐋	thjp
钖	yhjp
	yajp
钦	qbjq
锨	xmjq
镢	jtjq
鍁	xmjq
鐝	jtjq
锭	dkjr
镟	xrjr
鏇	xrjr
铃	lkjs
钩	gzjs
镙	lojs
鍪	mzjs
铥	dqjs
銩	dqjs
鍅	fhjs
鏍	lojs
孿	lrjs
铿	kgjt
镭	lwjt
锚	mcjt
锉	cojt
镏	lqjt
镗	thjt
钿	tmjt
钿	dmjt
锱	zijt
钍	tujt
釷	tujt
銼	cojt
鎦	lqjt
鏜	thjt
鐳	lwjt
针	vfju
镞	zuju
钎	qmju
锌	xbju
幛	vhju
铧	hxju
钭	dzju
镡	xbju
镡	tjju
镡	ijju
鐾	bwju
镎	naju
釺	qmju
鈄	dzju
鋅	xbju
鎿	naju
鑹	crju
钝	dyjv
铠	kdjv
锟	kyjv
铖	igjv
钯	bajv
锍	lqjv
钲	vgjv
钤	qmjv
铊	tojv
铊	tajv
铯	sejv
锩	jrjv
铌	nijv
钆	gajv
釓	gajv
鈀	bajv
鈐	qmjv
鈮	nijv
鉳	pwjv
銠	lcjv
銫	sejv
鋮	igjv
鋶	lqjv
錈	jrjv
錕	kyjv
铑	lcjv
铓	mhjv
钰	yujw
帼	gojw
铨	qrjw
锃	zgjw
镦	dvjw
鈺	yujw
鋥	zgjw
鑀	aijw
锽	hljw
风	fgjx
钢	ghjx
镖	bnjx
镣	lnjx
镲	iajx
锶	sijx
锪	hojx
镱	yijx
鋱	tejx
錼	najx
鍃	hojx
鍶	sijx
鏚	qijx
鏢	bnjx
鐿	yijx
鑔	iajx
铽	tejx
幖	bnjx
凤	fgjy
锻	drjy
镶	xljy
镀	dujy
镊	npjy
镬	hojy
钣	bjjy
铱	yijy
锾	hrjy
锼	szjy
镘	mjjy
锿	aijy
锓	qbjy
銥	yijy
鋟	qbjy
錶	bnjy
鍰	hrjy
鎄	aijy
鎩	uajy
鎪	szjy
鏺	pojy
鑊	hojy
鑲	xljy
镮	hrjy
键	jmjz
链	lmjz
铤	tkjz
铤	dkjz
鋌	tkjz
鋌	dkjz
围	wwka
哼	hgka
啸	xnka
哑	yaka
呜	wuka
啡	fwka
呸	pwka
喳	vaka
喳	iaka
颐	yika
嚅	ruka
颚	eeka
嗝	geka
咝	sika
吖	yaka
吖	aaka
喱	lika
唪	fgka
吲	ybka
哜	jika
咁	gjka
咈	fuka
咺	xrka
哣	dzka
哣	pzka
啞	yaka
啴	toka
啴	tjka
啴	ijka
嗶	bika
嘓	goka
嘢	yeka
嘽	toka
嘽	tjka
嘽	ijka
噇	ilka
噓	xuka
噓	uika
嚌	jika
圌	ivka
圌	irka
圙	ltka
曱	gaka
甴	zaka
圆	yrkb
喷	pfkb
啪	pakb
啧	zekb
呗	bwkb
呗	bdkb
匮	kvkb
匮	gvkb
喈	jpkb
唢	sokb
赜	zekb
賾	zekb
唝	hskb
唝	gskb
嗊	hskb
嗊	gskb
嗩	sokb
㗾	xtkb
匾	bmkc
哷	lvkc
哷	lpkc
喯	bfkc
嘚	dekc
噀	xykc
圇	lykc
图	tukd
吴	wukd
吓	xxkd
吓	hekd
卧	wokd
咧	lpkd
呐	nekd
呐	nakd
哟	yokd
噢	ookd
喻	yukd
咚	dskd
哧	iikd
哆	dokd
唰	uxkd
嗨	hdkd
噔	dgkd
咔	kakd
咛	nkkd
嗲	dxkd
卟	bukd
呔	tdkd
呔	ddkd
呙	wokd
呙	wdkd
呙	wakd
呙	hekd
呙	gxkd
呙	gokd
凼	dhkd
喁	yskd
啭	vrkd
哕	ytkd
哕	hvkd
吳	wukd
呣	omkd
呣	mzkd
呣	vmkd
咑	dakd
唎	likd
啩	gxkd
啰	lokd
啲	dikd
喲	yokd
嗞	zikd
嘜	makd
嘜	mdkd
嘰	jikd
嚟	lwkd
嚟	likd
彧	yukd
哪	nake
园	yrke
嘟	duke
唧	jike
咣	glke
啷	lhke
哓	xnke
嘧	mike
咡	erke
嘅	geke
嘵	xnke
啕	tckf
嚯	hokf
囉	lokf
圐	kukf
嘎	gakg
呓	yikg
戢	jikg
咗	zokg
戙	dskg
嘿	hwkh
唬	hukh
咴	hvkh
嗪	qbkh
噍	jnkh
嗻	vukh
嗻	vekh
囌	sukh
囷	qykh
虽	svki
𪠳	ieki
唓	ieki
叽	jikj
咂	zakj
匦	gvkj
哳	vakj
匭	gvkj
骯	ahkj
啊	aakk
响	xlkk
吕	lvkk
嘻	xikk
咕	gukk
咖	kakk
咖	gakk
啥	uakk
嚣	xnkk
嘀	dikk
嗒	takk
嗒	dakk
喏	rekk
喏	nokk
嗬	hekk
叵	pokk
咭	kakk
咭	jikk
唁	yjkk
啮	npkk
啁	vzkk
啁	vckk
啁	tnkk
匼	qxkk
匼	kekk
吅	sskk
吅	xrkk
咍	hdkk
哃	tskk
啹	kokk
喎	wdkk
喎	wokk
嗆	qlkk
嗐	hdkk
嗰	gekk
嚚	ybkk
囧	jskk
另	lkkl
啦	lakl
勋	xykl
咙	lskl
唠	lckl
呦	yzkl
呖	likl
嘞	lwkl
嘞	lekl
勖	xukl
叻	lekl
劻	klkl
勛	xykl
嘮	lckl
嚨	lskl
吗	makm
嗓	shkm
咪	mikm
咻	xqkm
嗑	kekm
哚	dokm
啉	ljkm
啉	lbkm
嗌	yikm
嗌	aikm
啋	cdkm
嗎	makm
㗎	jxkm
㗎	gakm
唤	hrkn
喂	wwkn
咦	yikn
噗	pukn
嚎	hckn
喽	lzkn
哝	nskn
嘤	ykkn
囡	njkn
噱	xtkn
噱	jtkn
哞	mzkn
哏	hfkn
哏	gfkn
呋	fukn
哌	pdkn
唼	uakn
匽	yjkn
咉	yhkn
咹	eekn
咹	ankn
咹	vjkn
嘍	lzkn
噥	nskn
囅	ijkn
	wokn
㖞	wokn
咱	zjko
噜	luko
啃	kfko
嘈	ccko
唷	yoko
嘣	bgko
喑	ybko
圊	qkko
嗍	soko
唶	coko
啫	veko
啫	uiko
噲	kkko
嚐	ihko
嚕	luko
团	trkp
吵	ickp
嘭	pgkp
叼	dnkp
啵	bokp
咿	yikp
囫	hukp
唦	uakp
嘐	xnkp
噦	ytkp
噦	hvkp
吒	vakq
噘	jtkq
唣	zckq
贝	bwkr
啶	dkkr
唡	llkr
啢	llkr
嘥	sdkr
嗦	soks
吆	ycks
呤	lkks
噙	qbks
辔	pwks
哙	kkks
嗉	suks
唥	lhks
噝	siks
囜	nbks
喔	wokt
喔	ookt
喵	mnkt
噻	sdkt
唑	zokt
喹	kvkt
嘡	thkt
噃	bokt
噹	dhkt
唉	aiku
哗	hxku
啤	piku
啐	qiku
啐	cvku
嗥	hcku
噼	piku
哔	biku
𠮶	geku
呯	pkku
唞	tcku
唞	dzku
嗱	naku
斝	jxku
见	jmkv
吧	bakv
呢	nikv
呢	nekv
呃	eekv
吨	dykv
呛	qlkv
呲	zikv
呲	cikv
囤	tykv
囤	dykv
噶	gakv
囵	lykv
吡	pikv
吡	bikv
鼍	tokv
黾	mmkv
黾	mgkv
黾	mbkv
呒	omkv
唵	ankv
嚙	npkv
嚦	likv
囸	rikv
鼉	tokv
瓯	oukw
哐	klkw
唛	makw
唛	mdkw
啯	gokw
喤	hlkw
噉	djkw
噯	aikw
㕵	whkw
㘎	hjkw
㘚	hjkw
嗯	ogkx
嗯	enkx
哎	aikx
冈	ghkx
呕	oukx
嚓	iakx
嘹	lnkx
嘁	qikx
唿	hukx
嘌	pnkx
吣	qbkx
吔	yekx
咇	bikx
哋	dikx
噁	wukx
噁	eekx
㕮	tnkx
㕮	fukx
叹	tjky
嚷	rhky
吱	viky
嗡	wgky
嗖	szky
囔	nhky
嗫	npky
嗳	aiky
咩	mpky
嘬	zoky
匜	yiky
唚	qbky
嗮	sdky
噏	haky
噏	xiky
嚄	ooky
嚄	hoky
哒	dakz
嗵	tskz
囝	jmkz
哱	pokz
哱	bokz
哱	bakz
噠	dakz
颜	yjla
竖	uula
耩	jlla
龚	gslb
赣	gjlb
贛	gjlb
龔	gslb
为	wwld
办	bjld
耦	ould
䶮	yjld
龑	yjld
竞	jkle
聋	lsle
势	uilf
飒	salf
耪	phlf
麇	qylh
麇	jylh
麂	jilj
哿	gelk
耥	thlk
耠	holk
耢	lcll
耮	lcll
辦	bjll
亲	qblm
亲	qklm
耧	lzln
耬	lzln
耤	jplo
耤	jilo
产	ijlp
耖	iclp
歆	xblq
竑	hsls
砻	lslu
耱	molu
礱	lslu
瓿	bulw
勰	xplx
袭	xily
耲	hkly
耔	zilz
查	iama
验	yjma
监	jmma
检	jmma
桥	qnma
柜	juma
柜	gvma
骄	jnma
阎	yjma
驯	xyma
栅	vama
栅	ujma
栅	cema
驿	yima
阐	ijma
闸	vama
盎	ahma
榨	vama
盅	vsma
闩	urma
桠	yama
阈	yuma
闱	wwma
榉	juma
楂	vama
楂	iama
柙	xxma
棰	ivma
楦	xrma
桕	jqma
闈	wwma
驊	hxma
杻	nqma
杻	izma
柈	pjma
柈	bjma
樁	vlma
櫫	vuma
櫸	juma
粦	lbma
粪	ffmb
骥	jimb
槟	bkmb
槟	bbmb
阗	tmmb
桢	vfmb
骐	qimb
闐	tmmb
闠	gvmb
阓	gvmb
朳	bamb
楨	vfmb
槚	jxmb
橫	hgmb
檟	jxmb
櫝	dumb
树	uumc
骗	pmmc
驸	fumc
橱	iumc
榭	xpmc
骈	pmmc
駙	fumc
栟	bfmc
櫥	iumc
欂	bomc
糰	trmc
术	uumd
类	lwmd
栋	dsmd
桨	jlmd
阑	ljmd
驮	tomd
驮	domd
榆	yumd
骊	limd
杈	iamd
柠	nkmd
椤	lomd
阕	qtmd
栎	ytmd
栎	limd
棼	ffmd
椟	dumd
阏	eemd
柒	qimd
楱	zzmd
枘	rvmd
闋	qtmd
馱	tomd
馱	domd
杕	domd
杕	dimd
栘	yimd
栻	uimd
梂	qqmd
槳	jlmd
㮾	lhmd
㰀	limd
闻	wfme
阅	ytme
骁	xnme
梆	bhme
栉	vime
驺	zzme
杌	wume
骘	vime
阋	xime
郴	ifme
桡	rcme
桡	ncme
桄	glme
籼	xmme
閱	ytme
騭	vime
騶	zzme
柷	vume
柷	iume
梡	krme
梲	vome
棁	vome
槥	hvme
秈	xmme
枫	fgmf
骜	aomf
榷	qtmf
骓	vvmf
驁	aomf
榣	ycmf
欏	lomf
栈	vjmg
盏	vjmg
阀	famg
骋	igmg
枵	xnmg
梣	ifmg
棫	yumg
棽	ufmg
棽	ifmg
槜	zvmg
糕	gcmh
驴	lvmh
棂	lkmh
梌	tumh
梌	iamh
棪	yjmh
槱	yzmh
槱	icmh
檁	lbmh
盉	hemh
骚	scmi
蛊	gumi
闽	mbmi
糨	jlmi
栌	lumi
椠	qmmi
閩	mbmi
闹	ncmj
榄	ljmj
闶	khmj
枧	jmmj
閌	khmj
梘	jmmj
櫈	dgmj
櫬	ifmj
问	wfmk
骑	qimk
骂	mamk
阁	gemk
阔	komk
骆	lomk
驹	jumk
毡	vjmk
闾	lvmk
榈	lvmk
樯	qlmk
椐	jumk
栝	gxmk
栝	tmmk
栝	komk
骀	tdmk
榀	pbmk
闆	bjmk
枱	tdmk
枱	simk
枱	cimk
柖	ucmk
棓	pzmk
棓	bwmk
棓	bhmk
椆	vzmk
椆	izmk
椆	dnmk
楛	kumk
楛	humk
驾	jxml
枥	liml
栊	lsml
柺	gkml
櫳	lsml
欐	liml
闲	xmmm
闯	ilmm
阖	hemm
槛	kjmm
槛	jmmm
杩	mamm
榇	ifmm
阃	kymm
閫	kymm
骉	bnmm
榅	wfmm
榪	mamm
樑	llmm
橾	uumm
橾	qnmm
极	jimn
驶	uimn
骤	vzmn
樱	ykmn
棵	kemn
娄	lzmn
桉	anmn
驽	numn
阆	lhmn
樨	ximn
橼	yrmn
骒	kemn
枨	igmn
毪	mumn
閬	lhmn
騍	kemn
栐	ysmn
桹	lhmn
梾	ldmn
棖	igmn
棶	ldmn
椓	vomn
楩	pmmn
檞	jpmn
间	jmmo
楣	mwmo
椭	tomo
橹	lumo
阍	hymo
阊	ihmo
糌	zjmo
槠	vumo
氆	pumo
氇	lumo
榍	xpmo
閒	xmmo
閶	ihmo
閽	hymo
馹	rimo
驲	rimo
栒	xymo
棤	qtmo
榰	vimo
櫧	vumo
氌	lumo
糈	xumo
杨	yhmp
闭	bimp
桫	somp
糁	ufmp
骖	cjmp
粝	limp
糝	ufmp
阙	qtmq
糗	qqmq
阒	qumq
橛	jtmq
驵	zhmq
橥	vumq
駔	zhmq
杴	xmmq
闪	ujmr
骇	hdmr
阂	hemr
枞	zsmr
枞	csmr
閡	hemr
欞	lkmr
盦	anmr
构	gzms
栏	ljms
骡	loms
闳	hsms
骛	wums
驷	sims
闫	yjms
糍	cims
柃	lkms
閆	yjms
閎	hsms
騖	wums
㭕	qums
桩	vlmt
盐	yjmt
闺	gvmt
檑	lwmt
骝	lqmt
樘	thmt
柽	igmt
騮	lqmt
榃	tjmt
檔	dhmt
檯	tdmt
盔	kvmu
桦	hxmu
骅	hxmu
枰	pkmu
榫	symu
榘	jumu
糇	hzmu
槔	gcmu
餱	hzmu
杄	qmmu
枓	dzmu
椑	bwmu
櫆	kvmu
枪	qlmv
盘	pjmv
驰	iimv
驼	tomv
桅	wwmv
阉	yjmv
粼	lbmv
粑	bamv
栳	lcmv
阄	jqmv
栀	vimv
樾	ytmv
桤	qimv
枍	yimv
棬	qrmv
棬	jrmv
椸	yimv
檵	jimv
驻	vumw
骏	jymw
棱	lkmw
棱	lgmw
闵	mbmw
闰	rymw
阚	kjmw
阚	hjmw
闞	kjmw
闞	hjmw
杧	mhmw
桯	ykmw
桯	tkmw
檉	igmw
糉	zsmw
标	bnmx
闷	mfmx
驱	qumx
驳	bomx
骠	pnmx
骠	bnmx
氅	ihmx
骢	csmx
檫	iamx
柰	ndmx
檩	lbmx
粞	ximx
閪	hwmx
驄	csmx
梽	vimx
楒	simx
橑	lnmx
橞	hvmx
㭎	ghmx
样	yhmy
权	qrmy
驭	yumy
骧	xlmy
骟	ujmy
阌	wfmy
耰	yzmy
閿	wfmy
騸	ujmy
糙	ccmz
籽	zimz
闼	tamz
毽	jmmz
楗	jmmz
骣	ijmz
驏	ijmz
桲	bomz
梴	yjmz
梴	ijmz
梿	lmmz
槤	lmmz
娇	jnna
鸟	nnna
鸟	dnna
姬	jina
娅	yana
妞	nqna
鸦	yana
姗	ujna
鸭	yana
婶	sfna
婵	ijna
鹉	wuna
妤	yuna
鹂	lina
嬗	ujna
鸬	luna
妯	vzna
娌	lina
鸸	erna
鸫	dsna
䴓	uina
姅	bjna
姍	ujna
姮	hgna
婭	yana
嫿	hxna
鳾	uina
鴯	erna
鸝	lina
㛚	tsna
婴	yknb
鹦	yknb
嫔	pbnb
鹈	tinb
鹆	yunb
犋	junb
鵒	yunb
㜺	zjnb
鹊	qtnc
姘	pbnc
鹳	grnc
鹋	mnnc
犏	pmnc
鶓	mnnc
婷	tknd
鹤	hend
娱	yund
犊	dund
鸩	vfnd
嫫	mond
鹌	annd
妫	gvnd
䴕	lpnd
妭	band
娛	yund
媄	mwnd
媆	rrnd
媆	nfnd
嬤	mand
嬤	mond
鴷	lpnd
鵪	annd
妇	fune
岛	dcne
娆	rcne
妧	yrne
妧	wjne
嬈	rcne
姣	xnnf
姣	jnnf
鸷	vinf
䴖	jknf
媱	ycnf
嬥	tnnf
鶄	jknf
㛃	jpnf
鹧	veng
犟	jlng
鹘	hung
鹘	gung
鸲	qung
娀	ssng
嫲	mang
鴝	qung
鶊	ggng
鹒	ggng
媯	gvnh
嫵	wunh
嬀	gvnh
嬿	yjnh
鶖	qqnh
鸕	lunh
鹙	qqnh
媸	iini
鸠	jqnj
凫	funj
媂	tinj
媂	dinj
鸣	mknk
鹃	jrnk
鸥	ounk
犄	jink
嫱	qlnk
鹗	eenk
牯	gunk
牿	gunk
姞	jink
姤	gznk
姤	dunk
婍	qink
婠	wjnk
婠	wank
婤	vznk
婤	iznk
婳	hxnk
婼	ronk
媧	wank
嬙	qlnk
鴞	xnnk
鵰	dnnk
鷗	ounk
鸮	xnnk
妈	manm
娴	xmnm
枭	xnnm
娓	wwnm
牦	mcnm
媪	aonm
鹇	xmnm
鷳	xmnm
鷴	xmnm
鹄	hunn
姝	uunn
媖	yknn
㛹	pmnn
婧	jkno
眚	ugno
䴗	juno
鶪	juno
奶	ndnp
姊	zinp
鹅	eenp
鸳	yrnp
鸨	bcnp
娣	dinp
鸱	iinp
鸹	gxnp
鹎	bwnp
䴘	tinp
媭	xunp
嫪	lcnp
嬃	xunp
鴰	gxnp
鶹	lqnp
鷈	tinp
鷉	tinp
鹠	lqnp
鸢	yrnq
姹	ianq
鹚	cinq
鹣	jmnq
奼	ianq
鶼	jmnq
鶿	cinq
婕	jpnr
娲	wanr
鸽	genr
姒	sinr
鹪	jnnr
牮	jmnr
妠	njnr
妠	nanr
媞	tinr
鶬	chnr
鸧	chnr
鸰	lknr
嬷	mons
鹜	wuns
鹬	yuns
婺	wuns
嫘	lwns
䴉	hrns
妘	yyns
姈	lkns
嬤	mans
嬤	mons
孌	lrns
鷥	sins
鹮	hrns
嬸	sfnt
妒	dunu
鸪	gunu
嫜	vhnu
鹩	lnnu
鹁	bonu
䴙	pinu
婞	xknu
婥	ionu
婻	njnu
嫭	hunu
鵓	bonu
鶘	hunu
鷿	pinu
鸊	pinu
她	tanv
妮	ninv
妩	wunv
媲	pinv
鹞	ycnv
鸵	tonv
妗	jbnv
鹛	mwnv
雞	jinv
姱	kxnv
姱	hunv
姽	gvnv
婘	qrnv
婘	jrnv
婫	kynv
婫	hynv
鶥	mwnv
牤	mhnv
鹫	jqnw
鹑	iynw
䴔	jnnw
媓	hlnw
嬡	ainw
牺	xinx
媳	xinx
妪	yunx
妳	ninx
嫄	yrnx
嫕	yinx
嫽	lnnx
牠	tanx
鸡	jiny
袅	nnny
婊	bnny
嫒	ainy
鹨	lqny
鹱	huny
裊	nnny
婌	uuny
嫚	mjny
嬛	xrny
嬛	qsny
嬛	hrny
嬝	nnny
鷚	lqny
鸌	huny
鹭	lunz
犍	jmnz
犍	qmnz
脸	lmoa
题	tioa
显	xmoa
睁	vgoa
肿	vsoa
睑	jmoa
腼	mmoa
肾	ufoa
脐	qioa
膻	ujoa
膻	djoa
韪	wwoa
颢	hcoa
肼	jkoa
胂	ufoa
瞵	lboa
膦	lboa
脰	dzoa
腨	uroa
𣈶	xroa
冔	xuoa
韙	wwoa
顥	hcoa
旴	xuoa
晅	xroa
暅	xroa
曈	tsoa
睜	vgoa
瞓	ffoa
瞓	xyoa
膑	bbob
臏	bbob
臜	zaob
臢	zaob
晪	tmob
时	uioc
脟	lpoc
膞	vroc
昪	bmoc
瞪	dgod
盯	dkod
胁	xpod
瞒	mjod
盼	pjod
腻	niod
瞩	vuod
睽	kvod
胭	yjod
昀	yyod
脶	lood
暌	kvod
腧	uuod
肽	tdod
腠	czod
胨	dsod
胩	kaod
晡	buod
眵	iiod
脲	nnod
脷	liod
䏝	vrod
昡	xrod
暵	hjod
朓	tnod
晓	xnoe
脘	wjoe
朊	rroe
脫	tooe
腳	jnoe
旵	ijoe
曏	xloe
胜	ugof
胶	jnof
臃	ysof
睢	svof
昉	fhof
旷	klog
胫	jkog
腭	eeog
胍	gxog
戥	dgog
肟	woog
曌	vcog
瞧	qnoh
瞅	izoh
炅	jsoh
炅	gvoh
曛	xyoh
昈	huoh
晱	ujoh
暂	zjoi
晕	yyoi
晖	hvoi
膙	jloi
螣	tgoi
昕	xboj
肮	ahoj
旯	laoj
䁪	vjoj
睒	ujoj
脑	ncok
晌	uhok
胳	geok
胳	gaok
晷	gvok
晗	hjok
眙	yiok
眙	iiok
朐	quok
朐	iyok
腒	juok
腡	look
䐃	jsok
昫	xuok
暱	niok
暿	xiok
睏	kyok
瞘	kzok
胧	lsol
昱	yuol
膪	vdol
膪	vaol
膪	ikol
昽	lsol
曨	lsol
曬	udol
腾	tgom
眯	miom
睬	cdom
臊	scom
瞌	keom
腽	waom
氍	quom
脎	saom
脒	miom
睏	kyom
鹏	pgon
眨	vaon
肤	fuon
胀	vhon
睐	ldon
脓	nson
胰	yion
胺	anon
媵	ykon
臁	lmon
䁖	lzon
腖	dson
昳	yion
昳	dpon
暕	ljon
暕	jmon
睞	ldon
瞜	lzon
㫰	lhon
腊	xioo
腊	laoo
腈	jkoo
腯	tuoo
〇	lkoo
肠	ihop
肜	rsop
胗	vfop
眢	yrop
肶	biop
䏲	tiop
䏲	dpop
旸	yhop
昒	huop
昣	vfop
肷	qmoq
腚	dkor
胲	hdor
昺	bkor
晐	gdor
暶	xror
昙	tjos
脍	kkos
瞀	mcos
胠	quos
昤	lkos
脏	zhot
膛	thot
瞄	mnot
眭	svot
眭	gvot
塍	igot
脞	coot
晊	viot
晔	yeou
腩	njou
胪	luou
盱	xuou
旰	gjou
旰	hjou
肸	xiou
啱	njou
啱	yjou
啱	ngou
旿	wuou
晫	voou
暲	vhou
睺	hzou
晚	wjov
盹	dyov
腌	yjov
腌	aaov
肫	iyov
肫	vyov
暍	heov
暱	niov
眶	klow
睃	soow
腘	goow
晙	jyow
朘	jrow
㬚	ieow
瞟	pnox
晾	llox
膘	bnox
眍	kzox
腙	zsox
腍	rfox
䏡	uiox
喺	xiox
暧	aioy
臌	guoy
瞍	szoy
胈	baoy
胣	iioy
脤	ufoy
脿	bnoy
䲢	tgoy
鰧	tgoy
昄	bjoy
㬊	hroy
脖	booz
脬	pcoz
瞇	mioz
须	xupa
顺	uypa
释	uipa
乌	wupa
乔	qnpa
颇	popa
颖	ykpa
颍	ykpa
裣	lmpa
袆	hvpa
褘	hvpa
鱟	hzpa
祎	yipa
禕	yipa
质	vipb
舆	yupb
祯	vfpb
夤	ybpb
衬	ifpc
禱	dcpc
乐	ytpd
乐	lepd
补	bupd
祸	hopd
乓	phpd
袄	aopd
囱	cspd
衩	iapd
氐	dipd
牍	dupd
祆	xmpd
祧	tnpd
牖	yzpd
褕	yupd
裆	dhpe
岙	aope
嶴	aope
祊	bgpf
粵	ytpg
舄	xiph
齄	vaph
禚	voph
裤	kupi
裈	kypi
褲	kupi
视	uipj
币	bipj
觋	xipj
鼽	qqpj
虒	sipj
禘	dipj
褡	dapk
祜	hupk
袼	gepk
裯	izpk
嚳	kupk
祫	xxpk
褴	ljpm
臬	nppm
祃	mapm
禡	mapm
长	vhpn
长	ihpn
袜	wapn
褛	lvpn
裉	kfpn
褚	vupo
褚	vepo
褚	iupo
裥	jmpo
褙	bwpo
襇	jmpo
襉	jmpo
彤	tspp
乒	pkpp
衹	vipq
齇	vapq
襝	lmpr
么	meps
么	ycps
么	mops
丢	dqps
祛	qups
袪	qups
丟	dqps
褔	fupt
垕	hzpt
飧	sypu
襻	pjpu
戶	hupu
甩	ukpv
乇	vepv
乇	topv
璺	wfpw
裎	igpw
舔	tmpx
囟	xbpx
裇	svpx
囪	cspx
祂	tapx
毁	hvpy
裱	bnpy
裰	dopy
袯	bopy
褟	tapy
襏	bopy
裢	lmpz
褳	lmpz
狰	vgqa
氟	fuqa
氚	irqa
氘	dcqa
氩	yaqa
猹	vaqa
猹	iaqa
氬	yaqa
狉	piqa
猃	xmqa
猙	vgqa
狈	bwqb
贰	erqb
獭	taqb
獷	glqb
关	grqd
狞	nkqd
忒	teqd
忒	tvqd
猡	loqd
氯	lvqd
猁	liqd
氡	dsqd
㺄	yuqd
兰	ljqe
獍	jkqe
狁	yyqe
氪	keqe
氙	xmqe
峱	ncqe
飙	bnqf
獒	aoqf
獾	hrqf
玀	loqf
犷	glqg
氢	qkqg
氫	qkqg
氮	djqh
狳	yuqh
獯	xyqh
蠲	jrqi
狮	uiqj
犰	qqqj
犺	khqj
猞	ueqk
狺	ybqk
㹢	jxqk
犸	maqm
氲	yyqm
猱	ncqm
猓	goqm
氳	yyqm
獁	maqm
獬	xpqn
氨	anqn
獴	mgqn
㹴	ghqn
猎	lpqo
猬	wwqo
猢	huqo
氰	qkqo
猸	mwqo
氖	ndqp
氕	ppqp
狱	yuqq
氦	hdqr
獫	xmqr
县	xmqs
兹	ziqs
兹	ciqs
狯	kkqs
綦	qiqs
猻	syqs
狴	biqt
獐	vhqu
犴	hjqu
犴	anqu
狨	rsqu
狍	pcqv
夔	kvqw
狻	srqw
獠	lnqx
猕	miqx
狲	syqx
惎	jiqx
狝	xmqx
獮	xmqx
獼	miqx
氧	yhqy
领	lkra
伟	wwra
倾	qkra
佣	ysra
颔	hjra
侨	qnra
伫	vura
俭	jmra
颌	hera
颌	gera
佥	qmra
侪	idra
伾	pira
倕	ivra
偁	igra
偁	ifra
偭	mmra
僜	dgra
僰	bora
頜	hera
頜	gera
俱	jurb
债	vdrb
侦	vfrb
偾	ffrb
傧	bbrb
僨	ffrb
儐	bbrb
俦	izrc
倴	bfrc
傉	nurc
僎	vrrc
僔	zyrc
弇	yjrc
传	vrrd
传	irrd
每	mwrd
份	ffrd
优	yzrd
偷	tzrd
侧	vdrd
侧	cerd
侧	zdrd
彻	ierd
仪	yird
俩	llrd
俞	yurd
伪	wwrd
衔	xmrd
佟	tsrd
俪	lird
仃	dkrd
俅	qqrd
傣	ddrd
佧	kard
氽	tyrd
汆	crrd
僦	jqrd
衎	kjrd
衕	tsrd
衚	hurd
衠	vyrd
伕	furd
伭	xrrd
伭	xmrd
侴	hcrd
俁	yurd
偰	xprd
傒	xird
儳	ijrd
㑊	yird
㑩	lord
侥	ycre
侥	jnre
傥	thre
佴	ndre
佴	erre
侁	ufre
倻	yere
㑇	vzre
㑳	vzre
仿	fhrf
傩	norf
傕	qtrf
傕	jtrf
僱	gurf
儸	lorf
徬	phrf
亿	yirg
戗	qlrg
仝	tsrg
侉	kxrg
俜	pkrg
仡	yirg
仡	gerg
戧	qlrg
伙	horh
僬	jnrh
倓	tjrh
儦	bnrh
俨	yjri
觎	yurj
仉	vhrj
伣	qmrj
佈	burj
俙	xirj
倘	thrk
侣	lvrk
偌	rork
倜	tirk
倌	grrk
侗	tsrk
侗	dsrk
徜	ihrk
佁	yirk
佁	iirk
佔	vjrk
佢	qura
佸	hork
侷	jurk
傖	ifrk
傖	cfrk
徛	jirk
伤	uhrl
龛	kjrl
们	mfrm
傈	lirm
僳	surm
毹	uurm
籴	dirm
偎	wwrn
侬	nsrn
偻	lvrn
偻	lzrn
伥	ihrn
徕	ldrn
侔	mzrn
胬	nurn
倮	lorn
鸺	xqrn
伋	jirn
俍	llrn
俠	xxrn
俫	ldrn
倀	ihrn
倈	ldrn
傢	jxrn
傢	jxrn
鵂	xqrn
储	iuro
俏	qnro
佾	yiro
偺	zjro
僩	xmro
儈	kkro
伢	yarp
隽	jyrp
隽	jrrp
佖	birp
僇	lurp
值	virq
佽	cirq
侂	torq
众	vsrr
肏	ccrr
偿	ihrs
仨	sars
侩	kkrs
仫	murs
俬	sirs
俬	sirs
侄	virt
畲	uert
偓	wort
儅	dhrt
畬	yurt
畬	uert
伞	sjru
仵	wuru
搿	geru
罉	chru
伦	lyrv
仓	chrv
仑	lyrv
佬	lcrv
伧	ifrv
伧	cfrv
伲	nirv
仳	pirv
偡	vjrv
复	furw
傻	uarw
徵	virw
徵	vgrw
儆	jkrw
佤	warw
瓴	lkrw
佺	qrrw
你	nirx
德	derx
佘	uerx
伛	yurx
傺	iirx
伈	xbrx
倞	llrx
倞	jkrx
倧	zsrx
傃	surx
傯	zsrx
悆	yurx
悆	uurx
仅	jbry
翎	lkry
徉	yhry
儋	djry
儇	xrry
偯	yiry
儴	xlry
儴	rhry
侹	tkrz
预	yusa
缠	ijsa
纠	jqsa
纽	nqsa
绯	fwsa
绅	ufsa
绊	bjsa
缰	jlsa
纬	wwsa
缅	mmsa
绛	jlsa
绎	yisa
纾	uusa
缬	xpsa
缍	dosa
绋	fusa
紓	uusa
紼	fusa
綞	dosa
繡	xqsa
繫	xisa
繫	jisa
繮	jlsa
纻	vusa
织	visb
缩	sosb
绩	jisb
缤	bbsb
缜	vfsb
缵	zrsb
缋	hvsb
縝	vfsb
繢	hvsb
纊	klsb
纘	zrsb
编	bmsc
缚	fusc
纣	vzsc
缛	rusc
绀	gjsc
罗	losd
终	vssd
续	xusd
约	ytsd
练	lmsd
纷	ffsd
纳	nasd
绿	lvsd
绿	lusd
罚	fasd
纨	wjsd
纫	rfsd
绂	fusd
餈	cisd
紈	wjsd
紉	rfsd
紱	fusd
綠	lvsd
綠	lusd
绗	hhsd
统	tsse
绕	rcse
绑	bhse
缉	jise
绉	vzse
綁	bhse
縐	vzse
维	wwsf
绞	jnsf
纺	fhsf
絷	visf
经	jksg
红	hssg
线	xmsg
绔	kusg
纥	hesg
纥	gesg
纩	klsg
缂	kesg
紇	hesg
紇	gesg
絝	kusg
緙	kesg
炱	tdsh
蟊	mcsi
绵	mmsj
缔	disj
缆	ljsj
给	gwsk
给	jisk
结	jpsk
绍	ucsk
络	losk
络	lcsk
绮	qisk
绸	izsk
缄	jmsk
绾	wjsk
绺	lqsk
缮	ujsk
绌	iusk
缟	gcsk
绐	ddsk
绱	uhsk
䌹	jssk
鞝	uhsk
絀	iusk
綹	lqsk
緔	uhsk
羁	jism
绦	tcsm
缢	yism
毵	sjsm
缲	scsm
缲	qnsm
枲	xism
毿	sjsm
縕	yysm
縕	wfsm
繅	scsm
缊	yysm
缊	wfsm
级	jisn
缘	yrsn
缕	lvsn
缨	yksn
绥	svsn
缫	scsn
缣	jmsn
绠	ggsn
缏	bmsn
綆	ggsn
緣	yrsn
緶	bmsn
縑	jmsn
縴	xmsn
縴	qmsn
绪	xuso
绷	bgso
绢	jrso
绚	xrso
绡	xnso
缙	jbso
缃	xlso
缗	mbso
缯	zgso
罾	zgso
綃	xnso
綳	bgso
緗	xlso
繒	zgso
纱	uasp
绣	xqsp
缪	mzsp
缪	mqsp
缪	mnsp
缈	mnsp
绨	tisp
綈	tisp
组	zusq
纸	visq
歜	iusq
纵	zssr
绽	vjsr
缇	tisr
眾	vssr
緹	tisr
罢	piss
罢	bass
绘	hvss
叁	sjss
纭	yyss
缡	liss
缧	lwss
叄	sjss
縭	liss
细	xist
缁	zist
絰	dpst
縶	vist
绖	dpst
纤	xmsu
纤	qmsu
绰	iosu
绰	icsu
绒	rssu
辫	bmsu
纡	yusu
缑	gzsu
罱	ljsu
睪	gcsu
紝	rfsu
緱	gzsu
纴	rfsu
绝	jtsv
继	jisv
纪	jisv
纯	iysv
绳	ugsv
罡	ghsv
纶	lysv
纶	grsv
纰	pisv
纰	bisv
绻	qrsv
绲	gysv
绁	xpsv
絕	jtsv
緄	gysv
纹	wfsw
缴	vosw
缴	jnsw
绫	lksw
繳	vosw
繳	jnsw
综	zssx
纲	ghsx
缭	lnsx
缥	pnsx
缌	sisx
緦	sisx
缓	hrsy
缎	drsy
缀	vvsy
绶	uzsy
缳	hrsy
缦	mjsy
繯	hrsy
缝	fgsz
缱	qmsz
缒	vvsz
繾	qmsz
坚	jmta
圳	vfta
坞	wuta
坯	pita
垩	eeta
墉	ysta
垭	yata
疃	trta
畀	bita
墼	jita
塥	geta
垏	lvta
垿	xuta
埇	ysta
埡	yata
埵	dota
墐	jbta
坝	batb
埙	xytb
坌	bftb
塤	xytb
埘	uitc
塮	xptc
弆	jutc
埚	gotd
坻	iitd
坻	ditd
坶	mutd
坼	ietd
圢	tktd
坋	fftd
坋	bftd
堧	rrtd
塏	kdtd
塱	lhtd
坠	vvte
垸	yrte
垸	hrte
垱	dhte
垫	dmtf
塄	lgtf
堃	kytf
塝	bhtf
垮	kxtg
圹	kltg
圬	wutg
圪	getg
坬	gxtg
垙	gltg
埪	kstg
塆	wjtg
墘	qmtg
壪	wjtg
墕	yjth
壎	xyth
堑	qmti
埽	sctj
幫	bhtj
墙	qltk
坷	ketk
墒	uhtk
坫	dmtk
垧	uhtk
垌	tstk
垌	dstk
垴	nctk
耇	gztk
坰	jstk
垎	hetk
埫	uhtk
埫	istk
堌	gutk
墑	ditk
垃	latl
垄	lstl
坳	aotl
垅	lstl
坜	litl
墈	kjtl
墡	ujtl
壠	lstl
垛	dotm
堞	dptm
墚	lltm
塭	wftm
壚	lutm
块	kktn
圾	jitn
埂	ggtn
墀	iitn
埭	ddtn
垵	antn
埌	lhtn
墣	putn
㙘	yctn
㚻	jitn
增	zgto
垍	jito
堉	yuto
堾	irto
壩	bato
场	ihtp
埸	yitp
埗	butp
畎	qrtq
圫	yutq
圫	vytq
坥	qutq
垞	iatq
垡	fatr
埞	ditr
堨	yetr
堨	eetr
堨	aitr
堨	vdtr
㙦	xptr
坛	tjts
垒	lwts
坽	lkts
垚	yctt
堐	yatt
堼	fgtt
墦	fjtt
壋	dhtt
圩	xutu
圩	wwtu
堠	hztu
垆	lutu
埤	pitu
圲	qmtu
垾	hjtu
墊	dmtu
毗	pitv
垦	kftv
坨	totv
畹	wjtv
坭	nitv
圯	yitv
圮	pitv
垲	kdtv
埏	yjtv
埏	ujtv
埯	antv
堍	tutv
坉	tytv
坉	dytv
堲	jitv
塃	hltv
塈	jitv
壢	litv
坟	fftw
墩	dytw
坍	tjtw
埕	igtw
堎	lgtw
尘	iftx
塬	yrtx
埝	nmtx
堖	nctx
塽	ultx
圣	ugty
塌	taty
翥	vuty
畈	fjty
墁	mjty
垟	yhty
塅	drty
㙍	doty
垯	datz
垺	pztz
垺	futz
墶	datz
毕	biua
韩	hjua
碰	pgua
颠	dmua
壶	huua
硕	uoua
矫	jnua
磷	lbua
馅	xmua
颉	xpua
颉	jxua
颉	jpua
碴	iaua
馐	xqua
馑	jbua
砷	ufua
碹	xrua
砩	fwua
砩	fuua
硷	jmua
砟	vaua
榘	juua
礓	jlua
馇	iaua
壸	kyua
餷	iaua
饈	xqua
屝	fwua
硚	qnua
磾	diua
礆	jmua
馈	kvub
磺	hlub
碘	dmub
馔	vrub
碛	qiub
屄	biub
㞎	baub
擎	qkuc
饼	bkuc
礴	bouc
碥	bmuc
龙	lsud
卖	mdud
协	xpud
饿	eeud
砖	vrud
馋	ijud
砾	liud
挲	uaud
泵	bgud
馍	moud
矽	xiud
矾	fjud
硎	xkud
饫	yuud
硪	woud
碡	vzud
鼷	xiud
䃎	vaud
飣	dkud
餈	ciud
饃	moud
饞	ijud
饤	dkud
鼢	ffud
碔	wuud
饶	rcue
饵	erue
硗	qnue
挚	viuf
饺	jnuf
砜	fguf
碸	fguf
矿	klug
饯	jmug
砼	tsug
矻	kuug
馀	yuuh
碳	tjuh
蚀	uiui
砗	ieui
螱	wwui
擊	jiui
硨	ieui
确	qtuj
饰	uiuj
砸	zauj
壳	qnuj
壳	keuj
饥	jiuj
砚	yjuj
矶	jiuj
碲	diuj
觌	diuj
屌	dnuj
馆	gruk
躺	thuk
础	iuuk
饲	siuk
饷	xluk
啬	seuk
碉	dnuk
碱	jmuk
饴	yiuk
硌	louk
硌	geuk
屙	eeuk
鼯	wuuk
硐	dsuk
軀	quuk
冇	mcuk
喆	veuk
嚭	piuk
囍	xiuk
餎	leuk
餎	geuk
饹	leuk
饹	geuk
砢	louk
礄	qnuk
饬	iiul
砬	liul
砬	laul
攰	lwul
攰	gvul
磡	kjul
躲	doum
码	maum
磕	keum
碟	dpum
麴	quum
磲	quum
磉	shum
餼	xium
尷	gjum
丧	shun
馁	nwun
鼹	yjun
鹕	huun
砭	bmun
硖	xxun
屦	juun
礞	mgun
餵	wwun
屢	lvun
屨	juun
鼴	yjun
砆	fuun
硃	vuun
硤	xxun
餚	ycuo
碜	ifup
砀	dhup
饧	xkup
砑	yaup
餳	xkup
毐	aiup
碭	dhup
磣	ifup
砍	kjuq
饩	xiuq
华	hxur
饮	ybur
屣	xiur
层	cgus
砝	faus
馏	lqut
矬	cout
礌	lwut
砰	pguu
饪	rfuu
鼙	piuu
矸	gjuu
䃅	diuu
飪	rfuu
饱	bcuv
屉	tiuv
砣	touv
饨	tyuv
馄	hyuv
硭	mhuv
砘	dyuv
餛	hyuv
屜	tiuv
礅	dyuw
馓	sjuw
饊	sjuw
尪	whuw
硒	xiux
砹	aiux
硇	ncux
礤	caux
硵	luux
磠	luux
饭	fjuy
馒	mjuy
馊	szuy
彀	gzuy
嘏	guuy
毂	guuy
馕	nhuy
觳	huuy
磙	gyuy
羼	ijuy
餿	szuy
饢	nhuy
榖	guuy
饽	bouz
𩠌	ssuz
餑	bouz
餸	ssuz
屘	miuz
屘	mjuz
马	mava
肃	suva
签	qmva
频	pbva
颈	jkva
颈	ggva
箫	xnva
筠	jyva
暨	jiva
舀	ycva
笮	zova
笮	zeva
箅	biva
舯	vsva
笪	dava
肀	yiva
舴	zeva
篚	fwva
箨	tova
彐	jiva
簞	djva
籲	yuva
籲	xuva
籁	ldvb
篑	kvvb
箦	zevb
舥	pavb
异	yivc
导	dcvc
筹	izvc
发	favd
飞	fwvd
书	uuvd
买	mdvd
录	luvd
箩	lovd
篾	mpvd
簦	dgvd
舣	yivd
舠	dcvd
錄	luvd
彔	luvd
箓	luvd
籙	luvd
舢	ujve
篼	dzve
筇	qsve
岊	jpve
籮	lovf
笺	jmvg
戕	qlvg
舡	ghvg
戣	kvvg
虢	govh
篪	iivh
艅	yuvh
舻	luvi
黡	yjvi
舰	jmvj
凳	dgvj
觅	mivj
筛	udvj
笕	jmvj
簖	drvj
籪	drvj
齿	iivk
箬	rovk
篙	gcvk
笤	tnvk
笸	povk
笱	gzvk
筘	kzvk
䝙	iuvk
貙	iuvk
劲	jkvl
劲	jbvl
笼	lsvl
簏	luvl
笔	bivm
篮	ljvm
笃	duvm
艉	wwvm
艋	mgvm
簋	gvvm
巢	icvn
筷	kkvn
篓	lzvn
鸶	sivn
箧	qpvn
孓	jtvn
筻	ghvn
简	jmvo
箐	qkvo
箐	jkvo
艏	uzvo
艄	ucvo
筲	ucvo
步	buvp
乡	xlvp
笫	zivp
歲	svvp
簌	suvq
篱	livs
篡	crvs
繇	yzvs
繇	ycvs
舲	lkvs
甾	zdvt
貓	mcvt
颦	pbvu
飨	xlvu
竽	yuvu
筚	bivu
毌	wjvu
毌	grvu
籜	tovu
舱	chvv
邕	ysvv
巯	qqvv
彘	vivv
卺	jbvv
筢	pavv
舭	bivv
箢	yrvv
艴	fuvv
巹	jbvv
○	lkvv
艎	hlvw
舾	xivx
筊	jnvx
爱	aivy
歧	qivy
舨	bjvy
叚	xxvy
叚	jxvy
笾	bmvz
籩	bmvz
齐	qiwa
颤	vjwa
颤	ijwa
斋	vdwa
玮	wwwa
顼	xuwa
齑	jiwa
颏	kewa
颃	hhwa
亸	dowa
嚲	dowa
頊	xuwa
頦	kewa
玙	yuwa
玠	jpwa
珅	ufwa
琤	igwa
瑄	xrwa
瑋	wwwa
败	bdwb
琪	qiwb
琐	sowb
瓒	zjwb
璜	hlwb
珙	gswb
敫	jnwb
兲	tmwb
璵	yuwb
瓚	zjwb
弈	yiwc
处	iuwd
离	liwd
环	hrwd
赢	ykwd
嬴	ykwd
玎	dkwd
斓	ljwd
珩	hgwd
蠃	lowd
玢	ffwd
玢	bbwd
珧	ycwd
斕	ljwd
琍	liwd
琭	luwd
璣	jiwd
峦	lrwe
兖	yjwe
琊	yawe
兗	yjwe
珰	dhwe
璀	cvwf
雒	lowf
產	ijwf
瓤	rhwg
琰	yjwh
啟	qiwh
珲	hywi
珲	hvwi
现	xmwj
玑	jiwj
銮	lrwj
帟	yiwj
琦	qiwk
噩	eewk
瑭	thwk
璐	luwk
玷	dmwk
琚	juwk
珺	jywk
瑲	qlwk
瑲	chwk
务	wuwl
珑	lswl
玛	mawm
琛	ifwm
璨	cjwm
栾	lrwm
敉	miwm
杗	mhwm
鸾	lrwn
璎	ykwn
娈	lrwn
璩	quwn
玦	jtwn
昝	zjwo
玥	ytwo
珣	xywo
璿	xrwo
敌	diwp
彥	yjwp
斆	xtwp
斆	xnwp
琇	xqwp
珉	mbwq
亹	wwwq
亹	mfwq
璇	xrwr
敛	lmwr
脔	lrwr
珐	faws
备	bwwt
亩	muwt
璠	fjwt
璫	dhwt
挛	lrwu
甏	bgwu
饔	yswu
玕	gjwu
琬	wjwv
琨	kywv
玘	qiwv
玱	qlwv
玱	chwv
㻬	tuwv
玫	mwww
珏	jtww
玟	wfww
玟	mbww
敔	yuww
璈	aoww
璦	aiww
琼	qswx
琮	cswx
璁	cswx
忞	wfwx
忞	mbwx
璟	jkwx
变	bmwy
亵	xpwy
衮	gywy
瑗	yrwy
瑷	aiwy
裒	pzwy
裛	yiwy
珢	ybwy
珢	kfwy
孪	lrwz
琏	lmwz
璉	lmwz
举	juxa
恶	eexa
恶	wuxa
懂	dsxa
衅	xbxa
惮	djxa
惮	daxa
忡	isxa
忑	texa
忐	tjxa
悱	fwxa
悝	lixa
悝	kvxa
怍	vaxa
怿	yixa
鲎	hzxa
恧	nvxa
衃	pwxa
愐	mmxa
慆	tcxa
慬	qbxa
慬	jbxa
憕	vgxa
憕	igxa
憕	dgxa
懟	dvxa
总	zsxb
兴	xkxb
愤	ffxb
惯	grxb
懒	ljxb
愦	kvxb
黉	hsxb
憒	kvxb
窸	xixb
义	yixd
怀	hkxd
态	tdxd
忧	yzxd
恻	cexd
怵	iuxd
懑	mfxd
泶	xtxd
忉	dcxd
忭	bmxd
衊	mpxd
乸	naxd
弒	uixd
愷	kdxd
崽	zdxe
卹	xuxe
峃	xtxe
悅	ytxe
㤘	vzxe
㥮	vzxe
飘	pnxf
愣	lgxf
恝	jxxf
恔	xnxf
恔	jnxf
忆	yixg
悈	kexg
悈	jpxg
惔	tjxh
惔	djxh
恽	yyxi
惲	yyxi
觉	jtxj
觉	jnxj
惭	cjxj
恼	ncxk
惦	dmxk
喾	kuxk
惝	thxk
惝	ihxk
怊	icxk
怗	tpxk
慪	ouxk
慪	ouxk
恸	tsxl
戆	vlxl
戆	ghxl
戇	vlxl
戇	ghxl
杀	uaxm
愠	yyxm
怅	ihxn
惬	qpxn
尐	dixn
悢	llxn
愜	qpxn
懞	mgxn
懵	mgxo
惛	mfxo
惛	hyxo
愔	ybxo
愭	qixo
惕	tixp
慼	qixp
悬	xrxq
忾	xixq
忾	kdxq
恹	yjxq
忺	xmxq
懨	yjxq
歅	yjxq
歅	ybxq
您	nbxr
惩	igxr
怂	ssxr
憷	iuxr
尝	ihxs
恿	ysxs
愫	suxs
忪	vsxs
忪	ssxs
悭	qmxt
悻	xkxu
忏	ijxu
悫	qtxu
怔	vgxv
恳	kfxv
恺	kdxv
憨	hjxv
惋	wjxv
怆	ilxv
怃	wuxv
忳	vyxv
忳	tyxv
忳	dyxv
愒	kdxv
惫	bwxw
悯	mbxw
憝	dvxw
敩	xtxw
敩	xnxw
㥄	lkxw
惊	jkxx
憋	bpxx
懔	lbxx
怄	ouxx
尜	gaxx
卐	wjxx
恓	xixx
恓	qixx
悰	csxx
惗	npxx
憭	lnxx
懞	mgxx
慑	uexy
怼	dvxy
忮	vixy
惙	ivxy
惙	ioxy
让	rhya
讲	jlya
养	yhya
训	xyya
谨	jbya
译	yiya
诈	vaya
讳	hvya
诵	ssya
谑	xtya
霁	jiya
谄	ijya
诽	fwya
诤	vgya
颡	shya
讵	juya
颥	ruya
詎	juya
谉	ufya
顙	shya
顬	ruya
翀	isya
识	uiyb
识	viyb
谐	xpyb
对	dvyc
谢	xpyc
讨	tcyc
诗	uiyc
羿	yiyc
谝	pmyc
酹	lwyc
譸	uzyc
诪	uzyc
议	yiyd
诉	suyd
试	uiyd
误	wuyd
读	dzyd
读	duyd
订	dkyd
霉	mwyd
谕	yuyd
诫	jpyd
酱	jlyd
讷	neyd
诲	hvyd
诋	diyd
谗	ijyd
谟	moyd
酶	mwyd
谰	ljyd
讣	fuyd
酾	uiyd
酾	udyd
酚	ffyd
酞	tdyd
谫	jmyd
讕	ljyd
醬	jlyd
说	uoye
说	ytye
说	uvye
讪	ujye
诌	vzye
诜	ufye
酰	xmye
谠	dhye
訕	ujye
詵	ufye
說	uoye
說	ytye
說	uvye
謅	vzye
难	njyf
谁	uwyf
谁	uvyf
访	fhyf
讽	fgyf
谣	ycyf
翟	vdyf
翟	diyf
翟	zdyf
谤	bhyf
雠	izyf
戏	xiyg
讧	hsyg
讫	qiyg
谔	eeyg
谶	ifyg
雩	yuyg
羟	qlyg
羥	qlyg
谈	tjyh
诙	hvyh
谯	qnyh
醮	jnyh
酴	tuyh
羰	thyh
譙	qnyh
讜	dhyh
诨	hyyi
酽	yjyi
翚	hvyi
翬	hvyi
观	gryj
讥	jiyj
谛	diyj
话	hxyk
语	yuyk
调	tnyk
调	dnyk
诺	noyk
词	ciyk
诏	vcyk
诃	heyk
谪	veyk
谲	jtyk
诘	jpyk
诘	jiyk
诰	gcyk
诟	gzyk
酮	tsyk
谘	ziyk
诂	guyk
诒	yiyk
诒	ddyk
醅	pwyk
诎	quyk
醣	thyk
酤	guyk
詘	quyk
雾	wuyl
劝	qryl
雳	liyl
釃	uiyl
釃	udyl
谋	mzym
谍	dpym
谧	miym
谥	uiym
醞	yyym
霂	muym
课	keyn
艰	jmyn
谦	qmyn
诀	jtyn
诛	vuyn
酿	nlyn
谏	jmyn
谀	yuyn
诿	wwyn
诼	voyn
诔	lwyn
醭	buyn
諉	wwyn
諑	voyn
请	qkyo
诸	vuyo
谓	wwyo
询	xyyo
谱	puyo
诣	yiyo
谙	anyo
诮	qnyo
醑	xuyo
谮	zfyo
酯	viyo
諝	xuyo
谞	xuyo
䲠	iyyo
讶	yayp
诱	yzyp
诊	vfyp
谬	mqyp
谚	yjyp
欢	hryq
诧	iayq
叠	dpyq
谊	yiyq
诅	zuyq
谳	yjyq
讞	yjyq
该	gdyr
认	rfyr
羡	xmyr
诬	wuyr
酝	yyys
讼	ssys
诖	gxyt
詿	gxyt
讅	ufyt
许	xuyu
计	jiyu
讯	xyyu
评	pkyu
辩	bmyu
谭	tjyu
诶	eiyu
讦	jpyu
谇	svyu
酐	gjyu
誒	eiyu
誶	svyu
记	jiyv
论	lyyv
证	vgyv
诚	igyv
诡	gvyv
谎	hlyv
诞	djyv
霭	aiyv
谒	yeyv
讹	eeyv
酡	toyv
谌	ufyv
谌	ifyv
訾	ziyv
醌	kyyv
襬	bdyv
諶	ufyv
諶	ifyv
謊	hlyv
讬	toyv
酏	yiyv
醃	yjyv
醃	aayv
羓	bayv
雯	wfyw
诠	qryw
诳	klyw
谡	suyw
诓	klyw
醛	qryw
羧	soyw
誆	klyw
釅	yjyw
谅	llyx
酗	xuyx
讴	ouyx
谂	ufyx
諗	ufyx
设	ueyy
详	xlyy
诩	xuyy
谩	mjyy
谵	vjyy
诹	zzyy
谖	xryy
詡	xuyy
諼	xryy
譭	hvyy
譾	jmyy
叕	yiyy
叕	voyy
叕	liyy
叕	jtyy
敠	vvyy
谜	miyz
谴	qmyz
谆	vyyz
醚	miyz
还	hdza
还	hrza
进	jbza
遗	yiza
违	wwza
迈	mdza
踹	ikza
蹿	crza
跻	jiza
逦	liza
迓	yaza
邅	vjza
邐	liza
递	dizb
趴	pazb
踬	vizb
趱	zjzb
躜	zrzb
逭	hrzb
趲	zjzb
躦	zrzb
过	gozc
踌	izzc
蹰	iuzc
跗	fuzc
蹁	pmzc
趼	jmzc
躕	iuzc
达	dazd
跃	ytzd
蹬	dgzd
蹒	pjzd
趔	lpzd
踽	juzd
趵	bczd
跞	lozd
跞	lizd
蜅	puzd
远	yrze
运	yyze
趋	quze
跷	qnze
踯	vize
遄	irze
蹺	qnze
跤	jnzf
躏	lbzf
踅	xtzf
连	lmzi
躝	ljzj
趟	thzk
跆	tdzk
踮	dmzk
踣	bozk
䢛	jszk
踎	bwzk
踦	qizk
边	bmzl
勐	mgzl
踩	cdzm
跺	dozm
遴	lbzm
蹀	dpzm
躒	lozm
躒	lizm
选	xrzn
趿	tazn
躝	ljzn
𨅬	ljzn
蹦	bgzo
蹭	cgzo
遢	tazo
蹧	zczo
适	uizp
踢	tizp
迁	qmzp
遛	lqzp
踄	uezp
逛	glzq
趄	qpzq
趄	juzq
趑	zizq
迤	yizr
迕	wuzr
迮	zezr
逻	lozs
迨	ddzs
跬	kvzt
蹯	fjzt
蹓	lqzt
蹚	thzt
赶	gjzu
迟	iizu
跸	bizu
踔	iozu
趕	gjzu
躥	crzu
跑	pczv
辽	lnzv
跄	qlzv
迳	jkzv
邋	lazv
邈	mnzv
孢	bczv
跎	tozv
逯	luzv
躐	lpzv
趷	kezv
踡	qrzv
迍	vyzv
这	vezw
这	vwzw
逄	phzw
赵	vczx
孙	syzx
蹩	bpzx
跽	jizx
迆	yizx
迆	tozx
踱	dozy
蹑	npzy
蹋	tazy
躞	xpzy
䟴	vfzy
逊	xyzz
跹	xmzz
踺	jmzz
跶	dazz
躂	dazz
躚	xmzz
孖	zizz
孖	mazz
