#level1
一	aayi
上	aauh
中	aavs
里	aali
而	aaer
面	aamm
事	aaui
十	aaui
本	aabf
再	aazd
口	aakz
与	aayu
二	aaer
西	aaxi
由	aayz
非	aafw
五	aawu
且	aaqp
工	aags
止	aavi
耳	aaer
野	aaye
丁	aadk
互	aahu
甲	aajx
曲	aaqu
井	aajk
申	aauf
巾	aajb
串	aair
凸	aatu
凹	aawa
凹	aaao
亘	aagf
廿	aanm
亙	aagf
亜	aaya
車	aaju
車	aaie
円	aayr
冊	aace
門	aamf
門	aamf
頃	aaqk
頓	aady
鯉	aali
鱗	aalb
百	abbd
典	abdm
頼	abld
耐	acnd
鮒	acfu
専	acvr
鱒	aczy
不	adbu
下	adxx
天	adtm
小	adxn
内	adnw
求	adqq
雨	adyu
瓦	adwa
虫	adis
寸	adcy
甫	adfu
卜	adbu
卜	adbo
豊	adfg
弐	ader
三	aesj
児	aeer
鱈	aext
雅	afya
鮫	afjn
弼	agbi
馬	ahma
鰍	ahqq
融	airs
蚕	aicj
規	ajgv
帰	ajgv
石	akui
石	akdj
否	akfz
占	akvj
画	akhx
両	akll
鮎	aknm
鯛	akdn
勅	alci
勅	alii
麗	alli
来	anld
大	anda
大	andd
果	ango
水	anuv
更	angg
夫	anfu
未	anww
木	anmu
史	anui
束	anuu
丈	anvh
妻	anqi
央	anyh
末	anmo
夷	anyi
吏	anli
丙	anbk
農	anns
長	anvh
長	anih
婁	anlz
鹸	anjm
東	ands
業	anye
旧	aojq
曹	aocc
晋	aojb
魯	aolu
鮪	aoww
鯖	aoqk
鰭	aoqi
才	apcd
万	apwj
形	apxk
牙	apya
曳	apye
暢	apih
豆	aqdz
肉	arrz
里	atli
王	atwh
鮭	atxp
鮭	atgv
鰹	atjm
平	aupk
干	augj
卓	auvo
乾	auqm
乾	augj
正	avvg
比	avbi
整	avvg
北	avbw
七	avqi
歪	avwd
屯	avvy
屯	avty
髭	avzi
糸	avmi
糸	avsi
夏	awxx
璽	awxi
鯨	axjk
爾	axer
叔	ayuu
叢	aycs
鮮	ayxm
鰻	aymj
半	babj
痛	bats
写	baxp
宣	baxr
皆	bajp
羊	bayh
宙	bavz
窄	bavd
貞	bavf
貴	bagv
賛	bazj
購	bagz
頁	baye
頒	babj
額	baee
穴	bbxt
冥	bbmk
宿	bbxq
宿	bbsu
寅	bbyb
貧	bbpb
賓	bbbb
守	bcuz
冠	bcgr
痔	bcvi
貰	bcui
的	bdde
的	bddi
分	bdff
寒	bdhj
泉	bdqr
窃	bdqp
寡	bdgx
券	bdxr
券	bdqr
寓	bdyu
痢	bdli
負	bdfu
貯	bdvu
資	bdzi
賦	bdfu
寧	bdnk
完	bewj
密	bemi
癌	beai
責	bfze
空	bgks
貢	bggs
窮	bgqs
窯	bhyc
蜜	bimi
軍	bijy
究	bjjq
冗	bjrs
質	bjvi
寛	bjkr
窺	bjkv
容	bkrs
害	bkhd
官	bkgr
客	bkke
谷	bkgu
痴	bkii
寄	bkji
窟	bkku
貼	bktp
賂	bklu
賠	bkpw
賢	bkxm
員	bkyr
宮	bkgs
賀	blhe
寵	blis
米	bmmi
案	bman
宋	bmss
家	bnjx
安	bnan
病	bnbk
痕	bnhf
牢	bnlc
宴	bnyj
賑	bnvf
実	bnui
曾	bozg
曾	bocg
宵	boxn
宥	boyz
賄	bohv
賭	bodu
贈	bozg
曽	bocg
曽	bozg
弟	bpdi
穿	bpir
疲	bppi
疹	bpvf
財	bpcd
貿	bpmc
賜	bpci
突	bqtu
欲	bqyu
宜	bqyi
宅	bqvd
痘	bqdz
定	brdk
貨	brho
貸	brdd
賃	brlb
公	bsgs
宏	bshs
買	bsmd
富	btfu
塞	btse
塞	btsd
窒	btvi
審	btuf
宇	buyu
拳	buqr
疾	buji
宰	buzd
癖	bupi
宕	budh
賊	buzw
宛	bvyr
宛	bvwj
症	bvvg
貫	bvgr
費	bvfw
巻	bvjr
捲	bvjr
宝	bwbc
皇	bwhl
甑	bwzg
父	bxfu
察	bxia
宗	bxzs
寮	bxln
賞	bxuh
憲	bxxm
療	bxln
癒	bxyu
寂	byji
叛	bypj
翁	bywg
寝	byqb
疫	byyi
謄	bytg
販	byfj
痩	byuz
字	bzzi
甘	cagj
董	cads
革	cage
萱	caxr
芥	cajp
苧	cavu
苧	cank
華	cahx
葎	calv
葦	caww
蔵	cach
蔵	cazh
黄	cbhl
共	cbgs
薄	ccbo
薄	ccbc
蒋	ccjl
葬	cczh
蔚	ccww
蒔	ccui
莫	cdmo
藤	cdtg
蔑	cdmp
蒲	cdpu
葡	cdpu
葵	cdkv
菟	cdtu
苧	cdvu
苧	cdnk
荊	cdjk
夢	cdmg
莞	cewj
莞	cegr
茸	cers
葺	ceqi
蔀	cebu
芳	cffh
萄	cftc
薩	cfsa
難	cfnj
芸	cgyy
芸	cgyi
茎	cgjk
菰	cggu
蒐	cgsz
蒐	cgsz
芦	chlu
蒸	chvg
菌	chjy
蕉	chjn
荻	chdi
萩	chqq
蕪	chwu
薦	chjm
薫	chxy
蘇	chsu
繭	cijm
幕	cjmu
薪	cjxb
芹	cjqb
落	cklo
落	cklc
落	ckla
若	ckro
苦	ckku
荷	ckhe
蓉	ckrs
菩	ckpu
茄	ckqp
茄	ckjx
苛	ckke
苔	cktd
菅	ckjm
苫	ckuj
蒼	ckch
蕎	ckqn
蕗	cklu
勤	clqb
募	clmu
某	cmmz
茶	cmia
菜	cmcd
菊	cmju
藻	cmzc
藁	cmgc
葉	cmye
葉	cmxp
蓋	cmgd
薬	cmyc
藍	cmlj
驚	cmjk
英	cnyk
蒙	cnmg
莱	cnld
芙	cnfu
芝	cnvi
萎	cnww
蔦	cnnn
蘭	cnlj
著	covu
著	covo
著	cove
著	covc
昔	coxi
暮	comu
萌	comg
薯	couu
菖	coih
藷	couu
藷	covu
茅	cpmc
茂	cpmc
芽	cpya
蕩	cpdh
蕨	cqjt
歎	cqtj
茨	crci
芸	csyy
芸	csyi
苓	cslk
蒐	cssz
蔭	csyb
墓	ctmu
苗	ctmn
蓄	ctxu
藩	ctfj
蕃	ctfj
蕃	ctbo
草	cucc
芋	cuyu
荏	curf
荘	cuvl
世	cvui
花	cvhx
荒	cvhl
葛	cvge
巷	cvxl
巷	cvhh
苑	cvyr
芭	cvba
導	cvdc
蔽	cwbi
菱	cwlk
薮	cwsz
慕	cxmu
恭	cxgs
惹	cxre
茜	cxxi
茜	cxqm
蕊	cxrv
弊	cxbi
葱	cxcs
芯	cxxb
蒜	cxsr
蔓	cywj
蔓	cymj
蓑	cyso
蓬	czpg
蓮	czlm
到	dadc
争	davg
角	dajn
角	dajt
副	dafu
刺	daci
州	davz
油	dayz
涌	days
洲	davz
刑	daxk
湿	daui
津	dajb
刊	dakj
沸	dafw
濡	daru
頂	dadk
沖	dais
浄	dajk
淵	dayr
済	daji
溝	dagz
滅	damp
漁	dayu
瀕	dabb
瀬	dald
演	dbyj
判	dbpj
洪	dbhs
割	dbge
泊	dbbo
剃	dbti
浜	dbbh
浜	dbbb
則	dbze
頭	dbtz
漬	dbzi
潰	dbkv
将	dcjl
奔	dcbf
涛	dctc
奪	dcdo
対	dcdv
心	ddxb
太	ddtd
海	ddhd
列	ddlp
漠	ddmo
刃	ddrf
漏	ddlz
漆	ddqi
沃	ddwo
犬	ddqr
澄	ddig
澄	dddg
浦	ddpu
汰	ddtd
溺	ddnn
溺	ddni
汀	ddtk
汐	ddxi
凍	ddds
剣	ddjm
奨	ddjl
汎	ddfj
涙	ddlw
渋	ddse
測	ddce
湊	ddcz
洗	dexi
剥	debo
剥	debc
況	dekl
准	dfvy
契	dfxp
契	dfqi
淘	dftc
濯	dfvo
灘	dftj
江	dgjl
残	dgcj
滑	dghx
浅	dgqm
湾	dgwj
戦	dgvj
利	dhli
淡	dhdj
劇	dhju
魚	dhyu
為	dhww
濁	divo
滞	djvi
漸	djjm
可	dkke
奇	dkqi
奇	dkji
活	dkho
治	dkvi
河	dkhe
洞	dkds
洛	dklo
浩	dkhc
召	dkvc
召	dkuc
沿	dkyj
滴	dkdi
浴	dkyu
冶	dkye
沼	dkvc
溶	dkrs
殆	dkdd
凋	dkdn
別	dkbp
剛	dkgh
減	dkjm
渦	dkwo
渦	dkgo
満	dkmj
勉	dlmm
泣	dlqi
剖	dlpz
漉	dllu
湧	dlys
瀧	dlul
瀧	dlls
深	dmuf
温	dmwf
淋	dmlb
溢	dmyi
濫	dmlj
之	dnvi
象	dnxl
派	dnpd
永	dnys
良	dnll
浪	dnlh
殊	dnuu
液	dnye
凄	dnqi
汝	dnru
沫	dnmo
泳	dnys
汲	dnji
濠	dnhc
鴻	dnhs
巣	dncc
巣	dnic
決	dnjt
沢	dnze
渓	dnxi
漢	dnhj
濃	dnns
清	doqk
消	doxn
湖	dohu
潜	doqm
朗	dolh
潮	doic
湘	doxl
脊	doji
殉	doxy
沓	dota
沓	doda
漕	docc
渚	dovu
澗	dojm
瀦	dovu
制	dpvi
必	dpbi
波	dpbo
沙	dpua
泌	dpmi
泌	dpbi
剰	dpug
劉	dplq
洩	dpxp
渉	dpue
湯	dpth
状	dqvl
歌	dqge
汽	dqqi
殖	dqvi
次	drci
火	drho
凝	drnk
欠	drqm
欠	drqt
淀	drdm
創	dril
法	dsfa
冷	dslg
套	dstc
滋	dszi
潔	dsjp
溜	dtlq
涯	dtya
渥	dtwo
奮	dtff
浬	dtli
窪	dtwa
斗	dudz
汗	duhj
壮	duvl
淫	duyb
刷	duux
汁	duvi
色	dvse
色	dvud
死	dvsi
流	dvlq
免	dvmm
危	dvww
混	dvhy
沈	dvuf
登	dvdg
港	dvgh
池	dvii
泥	dvni
泡	dvpc
湛	dvvj
沌	dvdy
奄	dvyj
劃	dvhx
氾	dvfj
氾	dvfj
渇	dvke
滝	dvls
滝	dvul
主	dwvu
刻	dwke
注	dwvu
凌	dwlk
激	dwji
班	dwbj
剤	dwji
潤	dwry
源	dxyr
奈	dxnd
漂	dxpn
爽	dxul
添	dxtm
削	dxxt
削	dxxn
刈	dxyi
涼	dxll
没	dymw
没	dymo
酒	dyjq
洋	dyyh
漫	dymj
渡	dydu
淑	dyuu
浸	dyjb
澱	dydm
浮	dzfu
淳	dzvy
淳	dziy
漣	dzlm
邪	eaye
邪	eaxp
降	eaxl
降	eajl
隔	eage
岬	eajx
聯	ealm
頑	eawj
嶺	ealk
階	ebjp
附	ecfu
尋	ecxy
郎	edlh
峨	edee
隅	edyu
陳	edif
元	eeyr
院	eeyr
耶	eeye
防	effh
峰	effg
隆	efls
邦	efbh
陶	eftc
峯	effg
嵐	eflj
魂	eghy
嵯	egco
職	egvi
除	ehiu
炭	ehtj
陣	eivf
凱	ejkd
出	ekiu
阿	ekaa
阿	ekee
陪	ekpw
叩	ekkz
嵩	ekss
崎	ekqi
部	elbu
限	enxm
峡	enxx
隈	enww
険	enxm
隊	endv
崩	eobg
陥	eoxm
印	epyb
兜	epdz
祁	epqi
邸	epdi
卯	epmc
郵	epyz
陽	epyh
阻	eqzu
鄭	eqvg
岨	eqju
卸	erxp
岱	erdd
云	esyy
陰	esyb
都	etdz
都	etdu
崖	etya
陛	etbi
陸	etlu
陸	etlq
却	euqt
岸	euan
岩	euyj
郁	euyu
障	euvh
那	evna
些	evxp
即	evji
幽	evyz
郡	evjy
陀	evto
耽	evdj
郷	evxl
郭	ewgo
陵	ewlk
峻	ewjy
郊	ewjn
巌	ewyj
示	exui
崇	exis
隙	exxi
聴	extk
際	exji
隠	exyb
恥	exii
取	eyqu
岐	eyqi
阪	eybj
随	ezsv
静	fajk
担	fadj
排	fapd
抽	faiz
撞	favl
拒	faju
奉	fafg
捧	fapg
押	faya
釜	fafu
麺	famm
挿	faia
搾	fava
拍	fbpd
旗	fbqi
撰	fbvr
摺	fbve
摺	fbue
損	fbsy
持	fcii
寿	fcuz
打	fdda
毒	fddu
摸	fdmo
挑	fdtn
抵	fddi
泰	fdtd
扮	fdbj
捕	fdbu
奏	fdzz
於	fdwu
於	fdyu
拭	fdui
捌	fdba
拶	fdzj
拶	fdza
掛	fdgx
摂	fdue
摂	fdnp
撲	fdpu
抑	feyi
揖	feyi
爺	feye
推	fftv
擢	ffvo
缶	fffz
缶	ffgr
拝	ffpd
拝	ffbd
揺	ffyc
擁	ffys
控	fgks
拷	fgkc
秦	fhqb
撚	fhnm
撫	fhfu
掻	fisc
揮	fihv
抗	fjkh
折	fjve
折	fjue
斧	fjfu
摺	fjve
摺	fjue
帯	fjdf
拠	fjju
掃	fjsc
撹	fjjn
招	fkvc
据	fkju
括	fkko
拾	fkui
搭	fkda
拓	fkto
拓	fkta
摘	fkvd
拘	fkju
掘	fkjt
拙	fkvo
捨	fkue
拐	flgk
探	fmtj
操	fmcc
掬	fmju
麹	fmqu
採	fmcd
接	fnjp
按	fnan
扶	fnfu
振	fnvf
旅	fnlv
抹	fnmo
抹	fnma
欠	fnqm
欠	fnqt
挟	fnxp
挟	fnjx
扱	fnxi
択	fnze
択	fnvd
換	fnhr
指	fovi
青	foqk
春	foiy
措	foco
披	fppi
携	fpxp
抄	fpic
揚	fpyh
托	fqto
提	frti
提	frdi
旋	frxr
捷	frjp
擬	frni
素	fssu
払	fsfu
拡	fskl
拡	fsko
握	ftwo
描	ftmn
播	ftbo
挫	ftco
族	fuzu
挨	fuai
把	fvba
施	fvui
抱	fvbc
批	fvpi
掩	fvyj
挽	fvwj
捲	fvjr
掲	fvqp
掲	fvqi
掲	fvjp
撒	fwsa
麦	fwmd
撤	fwie
掴	fwgo
擾	fwrc
掠	fxlt
擦	fxca
捺	fxna
捻	fxnm
表	fybn
技	fyji
投	fytz
援	fyyr
授	fyuz
搬	fybj
撮	fyzo
撮	fyco
抜	fybo
抜	fyba
捜	fysz
挺	fztk
捉	fzvo
或	gaho
引	gayb
羽	gayu
序	gaxu
庸	gays
項	gaxl
弔	gadn
弾	gatj
彊	gajl
府	gcfu
戒	gcjp
底	gddi
弱	gdro
丸	gdwj
勺	gduc
庁	gdtk
廊	gelh
廓	geko
耀	gfyc
雛	gfiu
魔	ggmo
巧	ggqn
乙	ggyi
弧	gghu
庶	ghuu
輝	gihv
庫	giku
強	giql
強	gijl
席	gjxi
司	gksi
句	gkju
句	gkgz
唐	gkth
店	gkdm
功	glgs
麻	gmma
床	gmil
鞠	gmju
威	gnww
康	gnkh
鞭	gnbm
魅	gnmw
廉	gnlm
鞍	gnan
庚	gngg
鷹	gnyk
張	gnvh
鞘	gouc
鞘	goqn
旬	goxy
廟	gomn
力	gpli
刀	gpdc
乃	gpnd
勿	gpwu
戊	gpwu
腐	grfu
骸	grhd
勾	gsgz
弘	gshs
弦	gsxm
広	gsgl
座	gtzo
庄	gtvl
摩	gumo
磨	gumo
魁	gukv
戎	gurs
成	gvig
包	gvbc
鹿	gvlu
靴	gvxt
庇	gvbi
弛	gvii
庵	gvan
庖	gvpc
廃	gvfw
慶	gwqk
弥	gxmi
戚	gxqi
応	gxyk
度	gydu
度	gydo
庭	gztk
髄	gzsv
点	hadm
虚	haxu
虐	hant
扉	hafw
肇	havc
顧	hagu
黙	hamo
煩	hafj
種	havs
種	hais
積	hbji
燕	hcyj
烈	hdlp
移	hdyi
灯	hddg
爆	hdbc
灼	hdvo
虞	hdyu
黍	hduu
戻	hdlw
戻	hdli
煉	hdlm
燈	hddg
税	heuv
焼	heyc
焼	heuc
禿	hetu
房	hffh
雇	hfgu
稚	hfvi
戯	hgxi
秋	hhqq
炎	hhyj
燃	hhrj
炉	hhlu
黒	hhhw
燭	hivu
虎	hjhu
稀	hjxi
和	hkhe
和	hkho
和	hkhu
稿	hkgc
熔	hkrs
虜	hllu
焚	hmff
煤	hmmw
燥	hmzc
燦	hmcj
委	hnww
秩	hnvi
稼	hnjx
照	hovc
香	hoxl
肩	hojm
稽	hoji
膚	hofu
稲	hodc
然	hprj
秘	hpmi
秘	hpbi
秀	hpxq
穆	hpmu
秒	hpmn
彪	hpbn
勲	hpxy
勲	hpxy
租	hqzu
煎	hqjm
炊	hqiv
焦	hrjn
黛	hrdd
私	hssi
熊	hsxs
煮	htvu
煙	htyj
熱	htre
畑	httm
科	huke
秤	huig
稗	hubd
程	hwig
熟	hwuz
熟	hwuu
烹	hwpg
称	hxig
称	hxif
稔	hxrf
慮	hxlv
穂	hxsv
穏	hxwf
扇	hyuj
煽	hyuj
穣	hyrh
穫	hyho
季	hzji
蝉	iaij
厘	iali
蝋	iala
軸	iavz
輩	iabw
願	iayr
贋	ibyj
辱	icru
厨	iciu
輪	icly
蛾	idee
蟻	idyi
輔	idfu
輸	iduu
輯	ieji
雁	ifyj
蜂	iffg
較	ifjn
虹	ighs
載	igzd
轟	iihs
蟹	ijxp
軌	ijgv
斬	ijvj
唇	ikiy
蜘	ikvi
蛤	ikha
蛤	ikge
轄	ikxx
励	illi
蝶	imdp
辰	inif
蛸	ioxn
暦	ioli
蛎	ipli
軟	iqrr
厭	iqyj
螺	islo
転	isvr
齢	islk
蛙	itwa
蛭	itvi
軽	itqk
圧	itya
軒	iuxr
蛇	ivue
厄	ivee
厩	ivjq
虻	ivmg
歴	ivli
砲	ivpc
蚊	iwwf
轍	iwve
廠	iwih
原	ixyr
蝦	iyxx
厚	izhz
釧	jair
鉢	jabo
錘	jaiv
鍾	javs
鐘	javs
鎖	jbso
鎮	jbvf
鋳	jcvu
凡	jdfj
帆	jdfj
夙	jdsu
釘	jddk
釣	jddn
銚	jdyc
銚	jdtn
銚	jddn
鋪	jdpu
録	jdlu
鎧	jdkd
鐙	jddg
銃	jeis
銑	jexm
銑	jexi
鋼	jegj
鏡	jejk
鋒	jffg
錐	jfvv
雑	jfza
幌	jghl
銭	jgqm
鍔	jgee
鍬	jhqn
鳳	jhfg
触	jiiu
風	jifg
錦	jjjb
帖	jktp
覧	jklj
釦	jkkz
鈷	jkgu
鉛	jkqm
銅	jkts
銘	jkmk
鋸	jkju
鋸	jkju
鍋	jkgo
鏑	jkdi
鋤	jliu
鑑	jmjm
解	jnjp
解	jnxp
鉄	jntp
鉾	jnmz
銀	jnyb
錬	jnlm
鎌	jnjk
鎌	jnlm
帳	jnvh
帽	jomc
旭	joxu
錆	joql
錯	joco
錫	jpxi
欣	jqxb
欽	jqqb
錠	jrdk
鈴	jslk
鉱	jsgl
幅	jtfu
幡	jtfj
錨	jtmc
針	juvf
鐸	judo
鈍	jvdy
鉦	jvvg
幣	jxbi
鍍	jydu
鍛	jydr
鍵	jzjm
日	kari
山	kauj
目	kamu
叫	kajn
巨	kaju
臣	kaif
哩	kali
匪	kafw
喧	kaxr
嘘	kaxu
嘘	kaui
唾	kato
咋	kaze
咋	kaza
咋	kava
皿	kamb
唖	kaya
噸	kady
囲	kaww
顎	kaee
只	kbvi
唄	kbbw
唄	kbbd
噴	kbpf
噂	kczy
団	kctr
因	kdyb
咽	kdyj
咽	kdye
嘱	kdvu
圃	kdpu
臥	kdwo
諮	kdzi
咲	kdgr
喫	kdii
嚇	kdxx
嚇	kdhe
四	kesi
兄	kexs
匹	kepi
呪	kevz
唯	kfww
哲	kfve
吃	kgii
号	kghc
哉	kgzd
啓	khqi
吊	kjdn
匠	kjjl
匝	kjza
回	kkhv
同	kkts
器	kkqi
品	kkpb
固	kkgu
匿	kkni
嗣	kksi
臨	kklb
呂	kklv
噛	kknp
岡	kkgh
呆	kmdd
困	kmky
喋	kmva
喋	kmdp
吸	knxi
味	knww
啄	knvo
詠	knys
喚	knhr
嘆	kntj
骨	kogu
唱	koih
哨	kouc
噌	kocg
吻	kpwf
欧	kqou
吹	kqiv
叱	kqii
吠	kqfw
足	krzu
咳	krke
囚	krqq
轡	kspw
緊	ksjb
吐	kttu
呼	kuhu
叶	kuye
叶	kuxp
医	kuyi
田	kutm
喉	kuhz
嘩	kuhx
喝	kvhe
吟	kvyb
邑	kvyi
吋	kvcy
嚇	kvxx
嚇	kvhe
圏	kvqr
圏	kvjr
網	kvwh
国	kwgo
呈	kwig
匡	kwkl
唆	kwso
区	kxqu
区	kxou
凶	kxxs
図	kxtu
殴	kyou
園	kyyr
立	lali
端	ladr
童	lats
麟	lalb
耕	lagg
顔	layj
龍	lals
韻	lbyy
聾	lels
競	lejk
新	ljxb
帝	ljdi
親	ljqb
親	ljqk
加	lkjx
商	lkuh
耗	lmhc
麓	lmlu
努	lnnu
妾	lnqp
音	loyb
靖	loqk
脅	loxp
彦	lpyj
彰	lpvh
勢	ltui
塵	ltif
章	luvh
辛	luxb
竜	lvls
竣	lwjy
毅	lyyi
襲	lyxi
棒	mabh
桶	mats
桓	mahr
檀	matj
柚	mayz
類	malw
馴	maxy
柵	mava
柵	mauj
柵	mace
桝	majp
極	maji
構	magz
樺	mahx
盃	mabw
糧	mall
横	mbhg
棋	mbqi
柏	mbbo
柏	mbbd
盆	mbpf
粕	mbpo
糞	mbff
村	mccy
械	mcxp
樽	mczy
柑	mcgj
闘	mciu
梼	mctc
梼	mciz
梼	mcdc
樹	mcuu
模	mdmu
模	mdmo
梅	mdmw
杯	mdbw
梁	mdll
盗	mddc
粉	mdff
染	mdrj
桃	mdtc
朴	mdpu
朴	mdpo
朴	mdpn
渠	mdqu
杓	mduc
杓	mdbn
桁	mdhh
桁	mdhg
檎	mdqb
関	mdgr
柊	mdvs
栴	mdvj
桟	mdvj
棟	mdds
楽	mdlw
楽	mdyt
楽	mdle
様	mdyh
欄	mdlj
柳	melq
榔	melh
聞	mewf
櫛	mevi
校	mfxn
校	mfjn
椎	mfvv
椎	mfiv
楓	mffg
権	mfqr
盛	mgug
盛	mgig
盈	mgyk
栽	mgzd
朽	mgxq
粥	mgvz
樗	mgiu
閥	mgfa
梨	mhli
樵	mhqn
榛	mhvf
騒	misc
机	mjji
断	mjdr
析	mjxi
棉	mjmm
杭	mjhh
柿	mjui
機	mjji
格	mkge
椅	mkyi
枯	mkku
棺	mkgr
桐	mkts
杏	mkxk
梧	mkwu
粘	mkvj
粘	mknm
糖	mkth
橘	mkju
桔	mkju
桔	mkjp
問	mkwf
開	mkkd
閣	mkge
閤	mkhe
閤	mkge
駒	mkju
騎	mkqi
槍	mkql
橋	mkqn
監	mkjm
架	mljx
粒	mlli
駕	mljx
林	mmlb
森	mmsf
閑	mmxm
梱	mmky
櫨	mmlu
根	mngf
楼	mnlz
柄	mnbk
杖	mnvh
株	mnvu
橡	mnxl
梗	mngg
糠	mnkh
駅	mnyi
験	mnyj
桜	mnyk
棲	mnxi
棲	mnqi
検	mnjm
相	moxl
精	mojk
盟	momg
糊	mohu
糟	mozc
棚	mopg
梢	mouc
槽	mocc
椿	moiy
間	mojm
闇	moan
楯	mouy
楯	mody
櫓	molu
材	mpcd
梯	mpti
彬	mpbb
杉	mpuj
杉	mpua
閉	mpbi
楊	mpyh
益	mqyi
粗	mqcu
植	mqvi
楚	mriu
集	mrji
核	mrhu
核	mrhe
閃	mruj
松	msss
桧	mshv
桧	msgv
罵	msma
杜	mtdu
桂	mtgv
樫	mtjm
料	muln
楠	munj
杵	muiu
梓	muzi
樟	muvh
柘	muve
粋	mutv
粋	mucv
概	mvgd
柴	mvid
枕	mvvf
札	mvva
杷	mvpa
柁	mvto
柁	mvdo
枇	mvpi
馳	mvii
椀	mvwj
盤	mvpj
柱	mwvu
栓	mwur
閏	mwry
駐	mwvu
駿	mwjy
稜	mwlk
稜	mwlg
禁	mxjb
栖	mxxi
栖	mxqi
枢	mxuu
椋	mxll
駁	mxbo
駆	mxqu
悶	mxmf
標	mxbn
板	mybj
枝	myvi
椴	mydr
李	mzli
孟	mzmg
槌	mziv
嬬	naru
鴨	naya
嬰	nbyk
鵜	nbti
特	ncte
妖	ndyc
婆	ndpo
姿	ndzi
姻	ndyb
鴛	ndyr
鶴	ndhe
犠	ndxi
先	nexm
島	nedc
姓	nfxk
牲	nfug
妨	nffh
鳥	nhnn
鳥	nhdn
婦	njfu
鳩	njjq
如	nkru
始	nkui
告	nkgc
姑	nkgu
嬉	nkxi
嫡	nkdi
姶	nkya
姶	nkee
鳴	nkmk
鴎	nkou
甥	nlug
媒	nmmw
娘	nnnl
妹	nnmw
嫁	nnjx
嫌	nnxm
娠	nnuf
姦	nnjm
鵠	nnhu
婚	nohy
婿	noxu
娼	noih
物	npwu
妙	npmn
鴇	npbc
姐	nqjp
鳶	nqyr
鵡	nqwu
娃	ntwa
牡	ntmu
姪	ntvi
嫉	nuji
妊	nurf
妃	nvfw
姥	nvlc
娩	nvmm
牝	nvpb
鶏	nvji
鷲	nwjq
奴	nynu
妓	nyji
媛	nyyr
嬢	nynl
好	nzhc
鷺	nzlu
量	oall
背	oabw
睡	oauv
替	oati
胆	oadj
瞬	oauy
昨	oazo
旦	oadj
督	oadu
瞳	oats
腫	oavs
臓	oazh
題	oati
顕	oaxm
昇	oaug
貝	obbw
肘	ocvz
昇	ocug
時	ocui
暴	odbc
膝	odxi
朕	odvf
膜	odmo
晦	odhv
眺	odtn
曝	odbc
腺	odxm
脚	oejn
脱	oeto
昂	oeah
見	oejm
暁	oexn
星	ofxk
曜	ofyc
肪	offh
晃	oghl
腔	ogql
暫	oizj
肌	ojji
肺	ojfw
胸	okxs
昭	okvc
胎	oktd
膳	okuj
胴	okds
脳	oknc
腎	okuf
肋	ollw
肋	olle
勝	olug
騰	omtg
眼	onyj
腰	onyc
映	onyk
昧	onmw
豚	onty
脈	onmo
脈	onmd
脹	onvh
膿	onns
鵬	onpg
明	oomk
暗	ooan
朋	oopg
冒	oomc
晶	oojk
晴	ooqk
昌	ooih
脂	oovi
暑	oouu
曙	oouu
影	opyk
易	opyi
膨	oppg
腸	opih
眠	oqmm
是	orui
肱	osgs
曇	ostj
睦	otmu
早	ouzc
智	ouvi
肝	ougj
脆	ovcv
昆	ovky
肥	ovfw
腕	ovwj
鼎	ovdk
胞	ovbc
匙	ovui
匙	ovii
晩	ovwj
腹	owfu
旺	owwh
景	oxjk
瞥	oxpp
晒	oxud
臆	oxyi
県	oxxm
瞭	oxln
瞭	oxle
最	oyzv
服	oyfu
股	oygu
暖	oynr
肢	oyvi
暇	oyxx
腿	oztv
手	pauz
用	pays
神	pauf
重	pavs
重	pais
丹	padj
牛	panq
竹	pavu
鼻	pabi
川	pair
垂	paiv
袖	paxq
斤	pajb
丘	paqq
禅	pauj
禅	paij
臼	pajq
舛	pair
順	pauy
須	paxu
頗	papo
頴	payk
穎	payk
兵	pbbk
興	pbxk
輿	pbyu
禎	pbvf
升	pcug
甜	pctm
祷	pcdc
我	pdwo
多	pddo
外	pdwd
初	pdiu
奥	pdao
夕	pdxi
斥	pdii
舟	pdvz
兆	pdvc
禄	pdlu
卵	pdlr
補	pdbu
襖	pdao
月	peyt
岳	peyt
祝	pevu
卿	peqk
生	pfug
九	pgjq
灸	phjq
烏	phwu
所	pjso
祈	pjqi
視	pjui
帥	pjuk
師	pjui
后	pkhz
向	pkxl
名	pkmk
周	pkvz
舌	pkue
裕	pkyu
裾	pkju
袷	pkqx
喬	pkqn
祐	pkyz
禍	pkho
動	plds
血	pmxt
血	pmxp
禾	pmhe
牒	pmdp
人	pnrf
入	pnru
失	pnui
及	pnji
八	pnba
久	pnjq
朱	pnvu
爪	pnvx
爪	pnvc
瓜	pngx
乏	pnfa
裸	pnlo
乗	pnig
乗	pnug
釈	pnui
自	pozi
白	pobd
昏	pohy
盾	pody
旨	povi
身	ppuf
被	ppbw
被	pppi
祖	pqzu
氏	pqui
臭	pqxq
臭	pqiz
祇	pqqi
祇	pqvi
疑	pryi
系	psxi
系	psji
鬼	psgv
係	psxi
係	psji
福	ptfu
社	ptue
番	ptpj
番	ptfj
裡	ptli
乎	puhu
千	puqm
牌	pupd
辞	puci
卑	pubw
阜	pufu
壬	purf
片	pvpm
乱	pvlr
礼	pvli
毛	pvmc
鼠	pvuu
褐	pvhe
胤	pvyb
祉	pvvi
衿	pvjb
祭	pxji
襟	pxjb
祢	pxmi
禰	pxmi
反	pyfj
段	pydr
翻	pyfj
版	pybj
祥	pyxl
狸	qali
酋	qaqq
並	qabk
猟	qalp
其	qbqi
具	qbju
狽	qbbw
尊	qczy
狩	qcuz
前	qdqm
切	qdqp
式	qdui
狐	qghu
独	qidu
斯	qjsi
獅	qjui
狗	qkgz
助	qlvu
勘	qlkj
猛	qmmg
狼	qnlh
兼	qnjm
狭	qnxx
首	qouz
期	qoqi
普	qopu
猪	qovu
朔	qouo
欺	qqqi
狙	qqju
猷	qqyz
獄	qqyu
猫	qtmc
碁	quqi
甚	qvuf
犯	qvfj
狂	qwkl
瓶	qwpk
気	qxqi
猿	qyyr
猶	qyyz
獲	qyho
但	radj
年	ranm
作	razo
体	rati
伸	rauf
舞	rawu
律	ralv
介	rajp
伴	rabj
仲	ravs
儒	raru
乍	rava
俸	rafg
俳	rapd
偉	raww
備	rabw
傭	rays
傾	raqk
領	ralk
毎	ramw
金	rbjb
伯	rbbo
伯	rbbd
供	rbgs
偵	rbvf
債	rbvd
償	rbih
得	rcde
得	rcdw
待	rcdd
付	rcfu
偏	rcpm
侍	rcui
併	rcbk
併	rcbk
倫	rcly
行	rdxk
行	rdhh
倒	rddc
代	rddd
低	rddi
停	rdtk
街	rdjp
例	rdli
偶	rdou
衡	rdhg
俄	rdee
矢	rdui
侮	rdwu
禽	rdqb
俣	rdyu
術	rduu
衛	rdww
衝	rdis
側	rdvd
側	rdce
側	rdzd
僕	rdpu
儀	rdyi
命	remk
仙	rexm
御	reyu
仰	reyh
仁	rerf
催	rfcv
傍	rfbh
佼	rfjn
僅	rfjb
径	rgjk
伐	rgfa
佐	rgzo
乞	rgqi
余	rhyu
徐	rhxu
偽	rhww
無	rhwu
無	rhmo
仇	rjqq
仇	rjiz
観	rjgr
何	rkhe
信	rkxb
合	rkhe
合	rkge
含	rkhj
倍	rkbw
俗	rksu
佑	rkyz
伺	rksi
伺	rkci
伽	rkqp
伽	rkjx
伽	rkga
缶	rkfz
缶	rkgr
侶	rklv
倉	rkch
個	rkge
僑	rkqn
位	rlww
勧	rlqr
保	rmbc
休	rmxq
傑	rmjp
便	rnpm
便	rnbm
使	rnui
像	rnxl
件	rnjm
食	rnyi
食	rnui
食	rnsi
侠	rnxx
倭	rnwo
倹	rnjm
借	rojp
僧	rosg
循	roxy
儲	roiu
修	rpxq
伊	rpyi
彼	rpbi
傷	rpuh
伏	rqfu
歓	rqhr
似	rrui
徒	rrtu
従	rrtu
従	rrcs
会	rshv
会	rskk
令	rslk
伶	rslk
仏	rsfo
仏	rsfu
仏	rsfo
仏	rsfu
伝	rsir
伝	rsvr
伝	rsir
伝	rsvr
佳	rtjx
佃	rttm
佃	rtdm
什	ruui
什	ruuf
任	rurf
候	ruhz
午	ruwu
侯	ruhz
斜	ruxp
僻	rupi
仕	ruui
倖	ruxk
傘	rusj
他	rvta
今	rvjb
化	rvhx
征	rvvg
企	rvqi
倦	rvjr
俺	rvan
侃	rvkj
値	rvvi
全	rwqr
住	rwvu
微	rwww
往	rwwh
俊	rwjy
伍	rwwu
覆	rwfu
後	rwhz
徽	rwhv
複	rwfu
倣	rwfh
優	rwyz
復	rwfu
徴	rwvg
僚	rxln
価	rxjx
価	rxjp
係	rxxi
係	rxji
偲	rxsi
億	rxyi
億	rxyi
徳	rxde
依	ryyi
侵	ryqb
役	ryyi
叙	ryxu
伎	ryji
仮	ryjx
俵	rybn
隻	ryvi
仔	rzzi
仔	rzzd
促	rzcu
健	rzjm
予	sayu
預	sayu
糾	sajq
紐	sanq
紬	sayz
紳	sauf
緋	safw
編	sabm
緬	samm
緯	saww
繊	savi
繊	saxm
繊	saqm
繍	saxq
縮	sbso
績	sbji
弁	scbm
紺	scgj
縛	scfu
約	sdyt
約	sdyc
納	sdna
紛	sdff
終	sdvs
続	sdxu
緑	sdlv
緑	sdlu
線	sdxm
罰	sdfa
允	seyy
統	sets
紡	sffh
絞	sfjn
維	sfww
羅	sflo
幾	sgji
紅	sghs
織	sgvi
綿	sjmm
締	sjdi
台	sktd
紹	skuc
結	skjp
絡	sklo
絡	sklc
給	skgw
給	skji
綱	skgh
縞	skgc
繕	skuj
勇	slys
務	slwu
柔	smrz
繰	smsc
繰	smqn
予	snyu
牟	snmz
牟	snmu
級	snji
練	snlm
縁	snyr
署	souu
響	soxl
絢	soxr
絹	sojr
緒	soxu
参	spcj
参	spuf
矛	spmc
紗	spua
罷	sppi
罷	spba
置	sqvi
紙	sqvi
組	sqzu
繁	srfj
綻	srvj
縦	srzs
罪	sszv
紘	sshs
絃	ssxm
絵	sshv
細	stxi
経	stjk
纏	stij
能	svng
紫	svzi
紀	svji
純	sviy
継	svji
縄	svug
紋	swwf
綾	swlk
綜	sxzs
綬	syuz
綴	syvv
緩	syhr
縫	szfg
至	tavi
界	tajp
型	taxk
坦	tatj
埋	tamj
埋	tamd
坤	taky
畔	tapj
垣	tayr
壇	tatj
畢	tabi
室	tbui
填	tbtm
墳	tbff
異	tbyi
封	tcfg
寺	tcsi
塀	tcpb
赤	tdii
均	tdjy
赫	tdhe
卦	tdgx
町	tdtk
町	tddk
執	tdvi
塗	tdtu
境	tejk
堕	tehv
堕	tedo
堀	teku
墜	tevv
堆	tfdv
坊	tffh
考	tgkc
戴	tgdd
塊	tgkk
墨	thmo
坑	tjkg
略	tklt
域	tkyu
塔	tkta
培	tkpw
塘	tkth
垢	tkgz
埼	tkqi
堅	tkjm
男	tlnj
劫	tljp
塩	tmyj
畏	tnww
壕	tnhc
堰	tnyj
塚	tnvs
者	tove
堵	todu
胃	toww
増	tozg
留	tplq
場	tpih
基	tqji
塑	tqsu
埴	tqvi
畳	tqtp
畳	tqdp
走	trzz
坐	trzo
座	trzo
堤	trdi
去	tsqu
累	tslw
圭	ttgv
畦	ttqi
塁	ttlw
幸	tuxk
壁	tubi
坪	tupk
埠	tubu
地	tvde
地	tvdi
老	tvlc
城	tvig
堪	tvkj
墾	tvkf
塾	twuu
堂	txth
坂	tybj
報	tybc
壊	tyhk
壌	tyrh
孝	tzxn
士	uaui
土	uatu
餐	uacj
届	uajp
矩	uaju
昼	uavz
矧	uauf
韓	uahj
顛	uadm
碩	uauo
真	ubvf
射	ucue
研	ucyj
博	ucbo
碍	ucai
尉	ucyu
尉	ucww
餅	ucbk
尽	udjb
属	uduu
属	udvu
短	uddr
尤	udyz
尿	udnn
砥	uddi
餓	udee
磯	udji
克	ueke
売	uemd
餌	ueer
雄	ufxs
碓	ufdv
準	ufvy
確	ufqt
左	ugzo
乾	ugqm
乾	uggj
戟	ugji
灰	uhhv
礁	uhjn
蝕	uiui
撃	uiji
布	ujbu
尻	ujkc
飢	ujji
飾	ujui
硯	ujyj
知	ukvi
喜	ukxi
古	ukgu
居	ukju
右	ukyz
局	ukju
吉	ukji
屈	ukqu
嘉	ukjx
砧	ukvf
飴	ukyi
飼	uksi
館	ukgr
矯	ukjn
勃	ulbw
勃	ulbo
協	ulxp
尾	umww
展	unvj
硬	unyk
尺	unii
屡	unlv
犀	unxi
喪	unsh
隷	unli
有	uoyz
看	uokj
朝	uovc
朝	uoic
胡	uohu
屠	uotu
屑	uoxp
馨	uoxb
硝	uoxn
層	uocg
声	upug
破	uppo
砂	upua
砺	upli
屍	upui
直	uqvi
献	uqxm
款	uqkr
隼	ursy
碇	urdk
飲	uryb
礎	uriu
索	usso
磁	usci
在	utzd
屋	utwu
南	uunj
碑	uubw
斡	uuwo
幹	uugj
砕	uusv
尼	uvni
碗	uvwj
磐	uvpj
硫	uvlq
壱	uvyi
飽	uvbc
饗	uvxl
碧	uwbi
履	uwlv
躯	uxqu
友	uyyz
支	uyvi
殿	uydm
鼓	uygu
翰	uyhj
飯	uyfj
殻	uyke
殻	uyqn
穀	uygu
存	uzcy
了	vale
了	valn
子	vazi
女	vanv
弗	vafu
丑	vaiz
笛	vadi
丞	vaig
舜	vauy
箪	vadj
頻	vapb
弔	vadn
筆	vabi
粛	vaxu
粛	vasu
舶	vbbo
箕	vbji
巽	vbxy
箔	vbbo
等	vcdg
算	vcsr
爵	vcjt
符	vcfu
篇	vcpm
簿	vcbu
笑	vdxn
武	vdwu
母	vdmu
箭	vdjm
筑	vdvu
飛	vdfw
貌	vemc
竺	vevu
節	vejp
雌	vfci
幻	vghr
弓	vggs
筏	vgfa
醜	vgiz
災	vhzd
蛋	vidj
航	vjhh
管	vkgr
答	vkda
君	vkjy
船	vkir
筒	vkts
函	vkhj
笥	vksi
歯	vkii
箇	vkge
幼	vlyz
筋	vljb
笠	vlli
采	vmcd
艦	vmjm
築	vmvu
篠	vmxn
篤	vmdu
又	vnyz
承	vnig
策	vnce
妥	vnto
笈	vnji
艮	vngf
簾	vnlm
肯	vokf
眉	vomw
箱	voxl
籍	voji
箸	vovu
書	vouu
簡	vojm
第	vpdi
彩	vpcd
歩	vpbu
民	vqmb
以	vryi
疋	vrpi
舷	vsxm
纂	vszr
畿	vtji
竿	vugj
砦	vuvd
也	vvye
己	vvji
此	vvci
巴	vvba
既	vvji
豹	vvbc
疏	vvuu
乳	vvru
舵	vvdo
巳	vvsi
発	vvfa
範	vvfj
愛	vwai
糸	vxmi
糸	vxsi
受	vyuz
般	vybj
群	vyqy
皮	vypi
簸	vybo
収	vyuz
髪	vyfa
艇	vztk
理	wali
政	wavg
救	wajq
致	wavi
瑞	warv
珊	wauj
斐	wafw
亨	wahg
敷	wafu
憂	wayz
斉	waqi
斎	wavd
六	wblq
六	wblu
敗	wbbd
散	wcsj
弄	wcns
敬	wcjk
就	wdjq
玉	wdyu
夜	wdye
球	wdqq
亦	wdyi
冬	wdds
亭	wdtk
斌	wdbb
玩	wewj
充	weis
聖	weug
放	wffh
交	wfjn
離	wfli
攻	wggs
蛮	wimj
市	wjui
亮	wjll
処	wjiu
現	wjxm
高	wkgc
各	wkge
言	wkyj
吾	wkwu
珂	wkke
劾	wlhe
効	wlxn
敵	wldi
数	wmuu
条	wmtn
琳	wmlb
枚	wmmw
棄	wmqi
珠	wnvu
豪	wnhc
牧	wnmu
妄	wnwh
琢	wnvo
瑛	wnyk
玖	wnjq
牽	wnqm
畝	wnmu
育	woyu
盲	womh
瑚	wohu
膏	wogc
方	wpfh
珍	wpvf
敏	wrmb
亥	wrhd
徹	wrie
玄	wsxr
玲	wslk
璃	wsli
教	wtjn
畜	wtxu
畜	wtiu
赦	wtue
故	wugu
率	wuuk
率	wulv
卒	wuzu
卒	wucu
敢	wvgj
改	wvgd
亡	wvwh
琴	wvqb
琉	wvlq
琶	wvpa
琵	wvpi
望	wwwh
斑	wwbj
敦	wwdy
変	wwbm
文	wxwf
京	wxjk
衣	wyyi
哀	wyai
衷	wyvs
衰	wyuk
褒	wybc
裏	wyli
環	wyhr
享	wzxl
孜	wzzi
悲	xabw
忠	xavs
恒	xahg
患	xahr
愚	xayu
憧	xais
酉	xayz
単	xadj
単	xauj
単	xaij
恵	xahv
悪	xaee
悪	xawu
憐	xalm
慎	xbuf
慣	xbgr
慾	xbyu
憤	xbff
急	xdji
忍	xdrf
尖	xdjm
悔	xdhv
愉	xdyu
当	xedh
光	xegl
党	xedh
悦	xeyt
兇	xexs
性	xfxk
慧	xfhv
雀	xfqt
惟	xfww
感	xggj
忽	xghu
恐	xgks
惑	xgho
瓢	xgpn
恢	xhhv
愁	xhiz
蛍	xiyk
常	xjih
希	xjxi
怖	xjbu
覚	xjjt
覚	xjjn
尚	xkuh
恩	xken
悟	xkwu
恰	xkqx
営	xkyk
悩	xknc
意	xlyi
劣	xllp
労	xllc
想	xmxl
栗	xmli
粟	xmsu
栄	xmrs
要	xnyc
快	xnkk
怒	xnnu
恨	xnhf
恕	xnuu
衆	xnvl
衆	xnvs
情	xoqk
惜	xoxi
省	xoxk
省	xoug
肖	xoxn
憎	xozg
肴	xoyc
惰	xodo
覇	xoba
嘗	xoih
少	xpuc
息	xpxi
惨	xpcj
怨	xpyr
悉	xpxi
憩	xpqi
悌	xpti
慈	xqci
懸	xqxr
獣	xquz
念	xrnm
愈	xryu
悠	xryz
懲	xrig
禦	xryu
怜	xslm
怯	xsqp
怠	xsdd
態	xstd
思	xtsi
怪	xtgk
掌	xuvh
志	xuvi
慰	xuww
悼	xudc
挙	xuju
忙	xvmh
慌	xvhl
忌	xvji
慨	xvkd
懇	xvkf
忘	xwwh
恋	xwlm
覆	xwfu
厳	xwyj
票	xxpn
憾	xxhj
惚	xxhu
憶	xxyi
総	xxzs
慢	xymj
誉	xyyu
裳	xyuh
裳	xyih
懐	xyhk
殺	xyua
学	xzxt
惇	xzdy
需	yaxu
酬	yaiz
酢	yazo
酢	yacu
訓	yaxy
詐	yava
誹	yafw
論	yaly
講	yajl
謹	yajb
霊	yalk
翼	ybyi
習	ybxi
警	ycjk
酎	ycvz
討	yctc
詩	ycui
謝	ycxp
護	ychu
美	ydmw
装	ydvl
裂	ydlp
叉	ydia
酌	ydvo
裟	ydua
訂	yddk
訴	ydsu
試	ydui
誤	ydwu
諭	ydyu
議	ydyi
醤	ydjl
義	ydyi
雪	yext
読	yedu
読	yedz
醒	yfxk
誓	yfui
訪	yffh
誰	yfuw
誰	yfuv
謡	yfyc
差	ygia
差	ygci
差	ygid
裁	ygcd
誇	ygkx
識	ygvi
識	ygui
談	yhtj
蚤	yizc
諦	yjdi
露	yklz
露	yklu
善	ykuj
酷	ykku
酪	yklc
詔	ykvc
詞	ykci
詰	ykjp
詰	ykji
話	ykhx
語	ykyu
調	yktn
調	ykdn
諮	ykzi
諾	ykno
翌	ylyi
袈	yljx
霧	ylwu
桑	ymsh
諜	ymdp
謀	ymmz
震	ynvf
訣	ynjt
訳	ynyi
課	ynke
謙	ynqm
養	ynyh
着	yovo
着	yove
着	yovc
著	yovu
著	yovo
著	yove
著	yovc
霜	youl
醐	yohu
詣	yoyi
請	yoqk
諸	yovu
謂	yoww
譜	yopu
製	ypvi
診	ypvf
誘	ypyz
諺	ypyj
謬	ypmq
詫	yqia
誼	yqyi
袋	yrdd
醍	yrti
該	yrgd
羨	yrxm
零	yslk
訟	ysss
雲	ysyy
雷	ytlw
翠	yucv
弁	yubm
計	yuji
訊	yuxy
許	yuxu
評	yupk
酔	yuzv
配	yvpw
託	yvto
記	yvji
証	yvvg
詑	yvia
誕	yvdj
誠	yvig
謁	yvye
電	yvdm
酸	ywsr
註	ywvu
詮	ywqr
誌	yxvi
認	yxrf
諒	yxll
双	yyul
霞	yyxx
設	yyue
詳	yyxl
諏	yyzz
譲	yyrj
譲	yyrh
醸	yynl
醇	yziy
酵	yzjn
謎	yzmi
速	zasu
遇	zayu
逐	zavu
距	zaju
逼	zabi
述	zauu
逗	zadz
遣	zaqm
迂	zayu
踊	zays
違	zaww
遺	zayi
迫	zbpo
迫	zbpd
蹟	zbji
運	zbyy
選	zbxr
遭	zczc
跳	zdtn
逸	zdyi
赴	zdfu
迩	zder
蹴	zdcu
跡	zdji
辺	zdbm
趨	zequ
逝	zfui
躍	zfyt
進	zfjb
遊	zfyz
孤	zggu
跨	zgkx
遮	zgve
践	zgjm
透	zhtz
遍	zhbm
連	zilm
近	zjjb
蹄	zjti
路	zklu
超	zkic
週	zkvz
過	zkgo
適	zkui
迦	zljx
迷	zmmi
造	znzc
踏	zota
追	zpvv
逃	zptc
迎	zpyk
延	zpyj
廷	zptk
返	zpfj
遁	zpdy
迭	zpdp
逓	zpdi
道	zqdc
送	zqss
逆	zqni
遂	zqsv
遵	zqzy
途	zrtu
迄	zrqi
通	zsts
孫	zssy
遠	ztyr
避	zubi
起	zvqi
越	zvyt
建	zvjm
退	zvtv
迅	zvxy
孔	zvks
遥	zvyc
巡	zvxy
逮	zvdd
逢	zwfg
遷	zxqm
遼	zxln
趣	zyqu
這	zyve
這	zyvw
遅	zyii
達	zyda
還	zyhr
還	zyhd
遜	zzxy
#level2
肆	aasi
冉	aarj
髯	aarj
丕	aapi
囗	aaww
鬣	aalp
卅	aasa
韭	aajq
鬲	aage
廾	aags
亞	aaya
釐	aaxi
釐	aali
韋	aaww
韜	aatc
顆	aake
鬚	aaxu
鬥	aadz
鮓	aava
鯒	aays
鯡	aafw
甦	aasu
畫	aahx
冀	abji
鬢	abbb
鬨	abhs
專	acvr
對	acdv
戈	adge
歹	addd
夥	adho
禺	adyu
黻	adfu
黼	adfu
黹	advi
豐	adfg
丼	adds
鯆	adbu
鯆	adpu
鯊	adua
鰥	adgr
鱧	adli
麥	admd
兀	aewu
堯	aeyc
鬩	aexi
鯢	aeni
魴	affh
鰲	afao
甦	afsu
丐	aggd
戛	agjx
戛	agga
麪	agmm
麪	agmm
焉	ahyj
臻	ahvf
蠹	aidu
蠶	aicj
覘	ajij
覯	ajgz
鑿	ajzc
靦	ajmm
靦	ajmm
鬧	ajnc
鰤	ajui
髻	akji
髫	aktn
嗇	akse
鹹	akxm
勁	aljk
勁	aljb
鰈	amdp
鰛	amwf
鰮	amwf
鱸	amlu
棘	anji
柬	anjm
耒	anlw
豕	anui
來	anld
夾	anjx
夾	anga
鮟	anan
麩	anfu
棗	anzc
睿	aorv
胄	aovz
豬	aovu
冑	aovz
鱠	aokk
晉	aojb
厂	apih
爿	appj
髟	apbn
鰺	apuf
虍	aqhu
兩	arll
鬆	asss
鯀	asgy
鯔	atzi
于	auyu
鮃	aupk
鱆	auvh
无	avwu
无	avmo
匕	avbi
匚	avkl
鬮	avjq
鮑	avbc
鯤	avky
黽	avmm
黽	avmg
黽	avmb
鰉	awhl
鰒	awfu
忝	axtm
鯰	axnm
鰓	axsd
鰾	axbn
鹵	axlu
滷	axlu
裘	ayqq
鬟	ayhr
攴	ayvi
鰌	ayqq
鰕	ayxx
宦	bahr
疥	bajp
疸	badj
賚	bald
頌	bass
瘧	bayc
瘧	bant
癲	badm
賽	bbsd
贔	bbbw
贖	bbuu
實	bbui
寶	bbbc
癩	bbld
竇	bbdz
疳	bcgj
賻	bcfu
窗	bdil
疼	bdtg
冤	bdyr
寞	bdmo
窕	bdtn
疣	bdyz
疔	bddk
贓	bdzh
癘	bdli
皚	bdai
岔	beia
皖	bewj
疝	beuj
兌	bedv
竈	bezc
窿	bfls
皎	bfjn
贅	bfvv
瘋	bffg
癰	bfys
魄	bgpo
兮	bgxi
穹	bgqs
賤	bgjm
痙	bgjk
痰	bhtj
寫	bhxp
帛	bjbo
冪	bjmi
皓	bkhc
豁	bkho
窘	bkjs
窖	bkjn
痞	bkpi
痂	bkjx
痼	bkgu
寤	bkwu
貽	bkyi
痾	bkoo
痾	bkee
痾	bkve
痾	bkke
瘡	bkil
窩	bkwo
窈	blyc
癆	bllc
寨	bmvd
瘟	bmwf
皙	bmxi
贐	bmjb
騫	bmqm
疚	bnjq
寐	bnmw
冢	bnvs
宸	bnif
痍	bnyi
痿	bnww
豢	bnhr
貶	bnbm
賺	bnvr
賺	bnzj
贊	bnzj
瘻	bnlz
窶	bnju
窶	bnju
眷	bojr
瘠	boji
癇	boxm
寥	bpln
瘍	bpyh
皸	bpjy
疽	bqju
貪	brtj
瘰	bslo
痃	bsxr
竊	bsqp
瘤	btlq
贄	btvi
罕	buhj
瘴	buvh
皋	bugc
瘁	bucv
搴	buqm
賁	bubi
賁	bubf
賣	bumd
屓	buxi
痺	bupi
痺	bubw
痺	bubi
癢	buyh
竄	bucr
它	bvta
卷	bvjr
疵	bvci
疱	bvpc
貲	bvzi
癧	bvli
痊	bwqr
瓮	bwwg
贇	bwyy
竅	bwqn
痣	bxvi
賈	bxjx
賈	bxgu
寇	bykz
痒	byyh
寰	byhr
皈	bygv
謇	byjm
瘢	bybj
癜	bydm
贍	byuj
寢	byqb
癬	byxr
蹇	bzjm
藏	cazh
藏	cach
菲	cafw
苒	carj
苣	caqu
苣	caju
薤	caxp
舊	cajq
蕭	caxn
蕷	cayu
薺	caqi
薺	caji
顴	caqr
蓿	cbxu
蘋	cbpk
蘋	cbpg
莽	ccmh
苻	ccfu
蓐	ccru
蒄	ccgr
蓴	cciy
蕁	ccxy
蕁	ccqm
莉	cdli
芬	cdff
茵	cdyb
藕	cdou
芍	cduc
藜	cdli
莓	cdmw
莪	cdee
苳	cdds
萬	cdwj
葯	cdyc
蒻	cdro
薊	cdji
藐	cemn
芫	ceyr
芫	ceyj
茆	cemc
蒭	ceiu
蕘	cerc
蒡	cfbh
藺	cflb
蘿	cflo
萼	cgee
莖	cgjk
荼	chtu
蓁	chvf
蔗	chve
葷	cihy
蒂	cjdi
蓆	cjxi
覲	cjjb
苟	ckgz
茹	ckru
茗	ckmk
茴	ckhv
蒿	ckhc
薹	cktd
萵	ckwo
蒟	ckju
薔	ckql
莅	clli
蘢	clls
勸	clqr
葆	cmbc
蘖	cmnp
薀	cmyy
藥	cmyc
蘆	cmlu
蘊	cmyy
蘗	cmnp
驀	cmmo
茉	cnmo
茱	cnvu
萋	cnqi
蒹	cnjm
莨	cnll
莨	cnlh
萸	cnyu
艱	cnjm
莢	cnjx
萇	cnih
藉	cojp
藉	coji
菁	cojk
葫	cohu
荀	coxy
苜	comu
蓍	coui
薈	cohv
莎	cpua
莠	cpyz
蓼	cplu
蓼	cpln
蔘	cpuf
蔘	cpcj
茯	cqfu
苴	cqju
苴	cqia
蕕	cqyz
歡	cqhr
苡	cryi
菘	csss
茲	cszi
茲	csci
藝	csyi
蕾	ctlw
薹	cttd
蔔	ctbu
蔔	ctbo
薛	cuxt
萍	cupk
苹	cupk
苹	cupg
萃	cucv
薜	cubi
蕈	cuxy
蔟	cucu
莊	cuvl
范	cvfj
芒	cvmh
茫	cvmh
蔬	cvuu
苞	cvbc
葩	cvpa
薨	cvhs
蓖	cvbi
菴	cvan
藹	cvai
薇	cwww
甍	cwmg
蔆	cwlk
藪	cwsz
艾	cxyi
艾	cxai
蔡	cxcd
菠	cybo
葭	cyjx
蓊	cywg
菽	cyuu
芟	cyuj
蘚	cyxm
荐	czjm
冲	dais
渊	dayr
滔	datc
渣	dava
剌	dala
潼	dats
湍	datr
奘	davl
湎	damm
冱	dahu
刪	dauj
剄	dajk
殫	dadj
沍	dahu
淨	dajk
濟	daji
瀟	daxn
溟	dbmk
淇	dbqi
黌	dbhs
殞	dbyy
殯	dbbb
濆	dbff
濱	dbbb
溥	dcpu
溽	dcru
將	dcjl
淪	dcly
潯	dcxy
濤	dctc
冰	ddbk
溪	ddxi
兔	ddtu
澳	ddao
瀑	ddpu
冽	ddlp
淤	ddyu
渝	ddyu
瀛	ddyk
卞	ddbm
汾	ddff
洌	ddlp
刳	ddku
剞	ddji
殪	ddyi
殲	ddjm
漿	ddjl
濘	ddnk
瀏	ddlq
瀾	ddlj
况	dekl
浣	dehr
汕	deuj
剴	dekd
洸	degl
澆	dejn
灌	dfgr
淮	dfhk
湃	dfpd
滂	dfph
夸	dgkx
刎	dgwf
瓠	dghu
殘	dgcj
淺	dgqm
滉	dghl
濺	dgjm
灣	dgwj
湫	dhqq
凜	dhlb
瀉	dhxp
广	digl
渾	dihy
沛	djpw
浙	djve
沂	djyi
淅	djxi
淦	djgj
滯	djvi
哥	dkge
沾	dkvj
涵	dkhj
淌	dkth
淌	dkih
洽	dkqx
涸	dkhe
沽	dkgu
溏	dkth
洳	dkru
豎	dkuu
奩	dklm
洶	dkxs
滄	dkch
劭	dluc
渤	dlbo
灑	dlsa
沐	dmmu
澡	dmzc
樊	dmfj
溘	dmke
渫	dmxp
馮	dmpk
馮	dmfg
滌	dmdi
瀘	dmlu
牀	dmil
决	dnjt
泛	dnfj
漾	dnyh
殃	dnyh
濮	dnpu
泱	dnyh
濂	dnlm
洙	dnvu
溷	dnhy
奐	dnhr
妝	dnvl
浹	dnjx
淒	dnqi
渙	dnhr
漲	dnvh
濛	dnmg
濛	dnmg
泪	dolw
奢	doue
剔	doti
溯	dosu
渭	doww
洵	doxy
涓	dojr
淆	doxn
昶	doih
潸	douj
汨	domi
潴	dovu
潛	doqm
濬	dojy
剩	dpug
刮	dpgx
渺	dpmn
涕	dpti
澎	dppg
殄	dptm
殤	dpuh
滲	dpuf
沮	dqju
漱	dquu
泯	dqmb
欹	dqqi
獎	dqjl
泅	drqq
劍	drjm
滿	drmj
漓	dsli
泓	dshs
泗	dssi
淞	dsss
潘	dtpj
奎	dtkv
涅	dtnp
湮	dtyj
沺	dttm
瀋	dtuf
瀋	dtuf
瀋	dtuf
瀋	dtuf
劈	dupi
辨	dubm
潭	dutj
淬	ducv
滓	duzi
剋	dukw
剋	duke
壯	duvl
泙	dupk
泙	dupg
滸	duxu
滸	duhu
澤	duze
泄	dvxp
淹	dvyj
剿	dvjn
剿	dvic
涎	dvxm
沱	dvto
豌	dvwj
匏	dvpc
宀	dvbc
沚	dvvi
滬	dvhu
澀	dvse
瀝	dvli
汪	dwwh
浚	dwjy
湟	dwhl
劑	dwji
夐	dwxs
瀲	dwlm
凉	dxll
刹	dxua
刹	dxia
洒	dxsa
凛	dxlb
沁	dxqb
潦	dxln
剽	dxpn
淙	dxcs
洫	dxxu
濾	dxlv
瀰	dxmi
瀰	dxmi
瀚	dyhj
澹	dytj
澹	dydj
溲	dysz
歿	dymo
沒	dymw
沒	dymo
滾	dygy
游	dzyz
潺	dzij
殍	dzpn
陷	eaxm
陲	eaiv
岫	eaxq
顳	eanp
崢	eavg
嶼	eayu
陌	ebmo
隕	ebyy
峙	ecvi
峙	ecui
邯	echj
邵	educ
嶝	eddg
聹	ednk
豈	edqi
嵎	edyu
弍	eder
聊	eeln
阮	eerr
聶	eenp
嶢	eeyc
崔	efcv
彗	efhv
糶	eftn
巍	egww
聘	egpb
屹	egyi
隗	egww
隗	egkv
嵬	egww
耿	ehgg
隰	ehxi
蚩	eiii
帚	ejvz
覬	ejji
崟	ejyb
嶄	ejvj
鄙	ekbi
崛	ekjt
鄂	ekee
郢	ekyk
峪	ekyu
聒	ekgo
鄲	ekdj
卻	ekqt
崗	ekgh
嶇	ekqu
隴	ells
隘	emai
鄰	emlb
聚	enju
岌	enji
陝	enuj
峽	enxx
峭	eoqn
嵋	eomw
隋	eosv
隋	eodo
邱	epqq
陂	eppo
陂	eppi
陂	epbw
陟	epvi
嵌	eqqm
岷	eqmb
嶽	eqyt
嶷	eryi
聳	erss
險	erxm
嶮	erxm
聆	eslk
巒	eslr
嶂	euvh
阡	euqm
耻	evii
陋	evlz
岑	evcf
郛	evfu
崑	evky
崑	evky
巉	evij
隍	ewhl
崚	ewlk
崚	ewlg
巖	ewyj
祟	exsv
聰	excs
聽	extk
隱	exyb
陬	eyzz
隧	ezsv
隨	ezsv
插	faia
拂	fafu
擅	fauj
揣	favv
揣	fatr
揣	faik
捶	faiv
拯	favg
拌	fapj
拌	fabj
抒	fauu
旌	fajk
抻	faif
舂	fais
靜	fajk
搆	fagz
擠	faji
拱	fbgs
揩	fbkd
颶	fbju
擯	fbbb
擴	fbko
罌	fbyk
搏	fcbo
拊	fcfu
拑	fcqm
摶	fctr
擣	fcdc
拔	fdba
拆	fdid
拇	fdmu
揄	fdyu
揆	fdkv
搦	fdno
抃	fdbm
揀	fdjm
揶	feye
搗	fedc
撓	fenc
擲	fevi
攝	feue
攝	fenp
掏	fftc
摧	ffcv
罐	ffgr
搖	ffyc
攤	fftj
找	fgvc
搓	fgco
扛	fgkh
扛	fggh
缸	fggh
蠢	fiiy
齧	finp
撕	fjsi
旆	fjpw
帶	fjdd
攪	fjjn
攬	fjlj
抬	fktd
扣	fkkz
拈	fknm
拮	fkjx
拮	fkjp
掎	fkji
颱	fktd
搶	fkql
搶	fkig
擔	fkdj
擱	fkge
攜	fkxp
拉	flla
抛	flpc
拗	flnq
拗	flao
勣	flji
撈	fllc
揉	fmrz
旄	fmmc
捫	fmmf
擽	fmle
缺	fnqt
抉	fnjt
掖	fnye
掾	fnyr
麸	fnfu
挾	fnxp
挾	fnjx
據	fnju
捐	fojr
掀	fqxm
捩	fqlp
擒	fsqb
纛	fsdc
挂	ftgx
捏	ftnp
擂	ftlw
擡	fttd
掉	fudn
抖	fudz
捍	fuhj
罅	fuxx
扞	fuhj
擇	fuvd
擇	fuze
抓	fvvx
扎	fvva
扼	fvee
旒	fvlq
艷	fvyj
擺	fvbd
旃	fwvj
撼	fxhj
撩	fxln
抔	fxpz
搜	fysz
攘	fyrh
攫	fyjt
撥	fybo
撻	fzta
疆	gajl
靡	gami
臧	gazh
靼	gada
戌	gaxu
鬻	gayu
鞴	gabw
彈	gatj
彈	gadj
廣	gbgl
廚	gciu
匆	gdcs
魃	gdba
魑	gdii
戍	gduu
匍	gdpu
汞	gdgs
鄒	gdzz
廁	gdsi
廁	gdce
弭	gemi
芻	geiu
鞏	gggs
戔	ggjm
鞦	ghqq
廡	ghwu
廩	ghlb
虱	giui
髑	gidu
覡	gjxi
廝	gjsi
咸	gkxm
匈	gkxs
骼	gkge
勒	gllw
勒	glle
劬	glqu
麾	gmhv
糜	gmmw
鞣	gmrz
廬	gmlu
盞	gmvj
弩	gnnu
鞅	gnyh
廨	gnxp
髏	gnlz
膺	goyk
廂	goxl
弸	gopg
廖	gpln
皺	gpvz
巫	grwu
魎	grll
縻	gsmi
麼	gsmo
麼	gsme
麼	gsyc
鞋	gtxp
甸	gtdm
匐	gtfu
廛	gtij
瓣	gubj
髀	gubi
魍	gvwh
廈	gwxx
廈	gwua
廳	gxtk
彌	gxmi
應	gxyk
骰	gytz
庠	gyxl
鞫	gyju
廢	gyfw
孕	gzyy
蹙	gzcu
髓	gzsv
韃	gzda
韆	gzqm
炸	hava
稻	hadc
炬	haju
燹	haxm
顱	halu
稱	haig
稱	haif
黷	hbdu
熾	hbii
扁	hcpm
扁	hcbm
烟	hdyj
黎	hdli
穢	hdhv
燒	heuc
熬	hfao
烽	hffg
魏	hgww
虧	hgkv
戲	hgxi
燻	hhxy
燻	hhxy
羆	hhpi
螢	hiyk
處	hjiu
熙	hkxi
炯	hkjs
烙	hklo
烙	hklc
黏	hknm
黠	hkxx
稠	hkiz
黜	hkiu
焙	hkbw
點	hkdm
烱	hkjl
烱	hkjs
營	hkyk
穡	hkse
黝	hlyz
勞	hllc
杰	hmjp
榮	hmrs
燼	hmjb
爍	hmuo
爐	hmlu
盧	hmlu
炳	hnbk
秧	hnyh
秣	hnmo
燠	hnyu
鶯	hnyk
煥	hnhr
犖	hnlo
稍	houc
黯	hoan
煦	hoxu
熏	hpxy
炒	hpic
煬	hpyh
默	hqmo
歔	hqxu
獻	hqxm
爛	hslj
燔	htfj
塋	htyk
熹	huxi
熨	huyy
熨	huyu
煢	huqs
稈	hugj
炮	hvpc
炮	hvbc
扈	hvhu
黔	hvqm
秕	hvbi
烝	hvvg
焜	hvky
煌	hwhl
虔	hwqm
稷	hwji
馥	hwfu
燉	hwdy
瑩	hwyk
熄	hxxi
穗	hxsv
燎	hxln
黥	hxqk
穩	hxwf
翩	hypm
羔	hygc
穰	hyrh
燬	hyhv
燧	hzsv
蠕	iaru
蛹	iays
蚯	iaqq
蚓	iayb
蜚	iafw
蚰	iayz
輦	ianm
靨	iaye
螟	ibmk
蟒	icmh
蟒	icmg
蝙	icbm
蚶	ichj
轉	icvr
蜈	idwu
蟆	idma
蚋	idrv
蝓	idyu
蜊	idli
蠣	idli
軾	idui
輳	idcz
齲	idqu
螂	ielh
蛻	ietv
蟯	ienc
蛟	ifjn
蚌	ifbh
蚌	ifbg
螯	ifao
蛩	igqs
輕	igqk
孅	igxm
孅	igqm
魘	igyj
蜍	ihiu
黶	ihyj
蜃	iiuf
蟲	iiis
厮	ijsi
蜥	ijxi
蜆	ijxm
蛔	ikhv
蛄	ikgu
蛞	ikko
蜩	iktn
蝸	ikwo
軻	ikke
輅	iklu
轎	ikjn
齠	iktn
齬	ikyu
轆	illu
勵	illi
蠑	imrs
轢	imli
轤	imlu
蛛	invu
螻	inlz
軼	inyi
輾	invj
輾	innm
輾	inzj
齦	inyb
齦	inkf
蝴	iohu
蜻	ioqk
脣	ioiy
蝟	ioww
蜴	ipyi
軫	ipvf
厖	ipmh
厥	iqjt
蛆	iqqu
蠍	iqxp
齟	iqju
仄	irze
輛	irll
蚣	isgs
蛉	islk
蠻	ismj
齡	islk
蝠	itfu
蟠	itpj
螳	itth
螫	itve
螫	itui
蟄	itve
輊	itvi
輜	itzi
輻	itfu
壓	itya
齷	itwo
蚪	iudz
蟀	iuuk
蝌	iuke
蝎	ivxp
蜷	ivqr
蜒	ivyj
蜿	ivwj
蠅	ivyk
軋	ivya
軋	ivva
軋	ivga
軛	ivee
輒	ivve
輓	ivwj
轣	ivli
齔	ivif
厦	iwxx
厦	iwua
蝗	iwhl
蝮	iwfu
蟶	iwig
愿	ixyr
蟋	ixxi
轗	ixkj
蟾	iyij
蠖	iyho
輟	iyio
轅	iyyr
蜉	izfu
蝣	izyz
齪	izio
幢	javl
幢	jail
鈕	janq
鉅	jaju
錚	javg
幃	jaww
幗	jago
釟	jbba
鏥	jbxq
鑽	jbzr
幀	jbvf
鉗	jcqm
鏘	jcql
鑄	jcvu
鑰	jcyt
鑰	jcyc
釵	jdid
鈞	jdjy
鉉	jdxr
鉞	jdyt
鍮	jdtz
鉚	jemc
鐃	jenc
鑷	jenp
帷	jfww
鑼	jflo
觚	jggu
錢	jgqm
鐫	jgjr
鐵	jgtp
幟	jgvi
觸	jiiu
鏨	jizj
咒	jkvz
覽	jklj
鉅	jkju
鉤	jkgz
銛	jkxm
銛	jktm
銛	jkgx
錮	jkgu
鍼	jkvf
鎔	jkrs
鎬	jkhc
鎬	jkgc
鑒	jkjm
鎰	jmyi
鑠	jmuo
帑	jnth
帑	jnnu
帙	jnvi
銖	jnvu
鋏	jnjx
鏤	jnlz
馗	jokv
銷	joxn
觴	jpuh
鈔	jpic
鏐	jplq
凭	jrpk
鑾	jslr
幄	jtwo
鈿	jttm
鈿	jtdm
錙	jtzi
鏗	jtkg
鐇	jtfj
鐺	jtig
鐺	jtdh
斛	juhu
鏃	juzu
鐔	juxb
鐔	jutj
鐔	juij
觜	jvzv
觜	jvzi
鉈	jvto
鉈	jvta
鉋	jvpc
鉋	jvbc
鋩	jvmh
鑞	jvla
凰	jwhl
銓	jwqr
鍠	jwhl
鐓	jwdv
鍄	jxll
鐐	jxln
幔	jymj
殳	jyuu
鈑	jybj
鏝	jymj
鐶	jyhr
钁	jyjt
鏈	jzlm
喘	kair
曰	kayt
呻	kauf
匣	kaxx
呷	kaxx
譁	kahx
啗	kadj
單	kauj
單	kaij
單	kadj
嘯	kaxn
國	kago
圍	kaww
頤	kayi
哄	kbhs
嗔	kbif
叭	kbba
匱	kbkv
匱	kbgv
嘖	kbze
圓	kbyr
咐	kcfu
嚼	kcjt
嚼	kcjn
哢	kcls
囀	kcvr
團	kctr
哦	kdoo
哦	kdee
吩	kdff
叮	kddk
喇	kdla
叨	kdtc
叨	kddc
咨	kdzi
噎	kdye
哺	kdbu
匯	kdhv
嚀	kdnk
體	kdti
吮	keuy
啣	kexm
囁	kenp
咬	kfyc
囃	kfza
雖	kfsv
嗟	kgjp
戰	kgvj
啾	khjq
啖	khdj
嗚	khwu
嚥	khyj
嚥	khye
嗤	kiii
囑	kivu
听	kjtk
嘴	kjzv
嘶	kjsi
啼	kjti
吭	kjkg
吭	kjhh
唏	kjxi
號	kjhc
喨	kjll
哈	kkha
呵	kkhe
喊	kkhj
咯	kklo
咯	kkka
咯	kkge
喀	kkka
唔	kkwu
唔	kkm
咄	kkdo
圄	kkyu
嚆	kkhc
冏	kkjs
區	kkqu
區	kkou
咼	kkwo
咼	kkwd
咼	kkwa
咼	kkhe
咼	kkgx
咼	kkgo
嘔	kkou
囂	kkxn
圖	kktu
嘛	kmma
噪	kmzc
咏	knys
哽	kngg
呱	kngx
喙	knhv
吽	knhs
呎	knii
嚶	knyk
嘲	kovc
嘲	koic
嗜	koui
喟	kokv
囿	koyz
呀	kpya
嗅	kqxq
嗽	kqsz
咀	kqju
咤	kqva
唳	kqli
歐	kqou
獸	kquz
售	kruz
噬	krui
嚏	krti
吶	krne
吶	krna
囹	kslk
囈	ksyi
哇	ktwa
咥	ktdp
喃	kunj
吁	kuyu
吁	kuxu
圉	kuyu
嗾	kusz
圈	kvqr
圈	kvjr
吼	kvhz
咆	kvpc
罔	kvwh
鬯	kvih
嘸	kvom
嗷	kwao
嗄	kwua
嗄	kwaa
嚴	kwyj
甌	kwou
网	kxwh
噤	kxjb
噫	kxyi
哂	kxuf
唸	kxnm
唸	kxnm
啜	kyio
啜	kyik
翳	kyyi
圜	kyyr
圜	kyhr
呶	kync
毆	kyou
哮	kzxn
嗹	kzlm
韵	layy
麒	lbqi
麝	lcue
耨	lcnz
竚	ldvu
竟	lejk
旁	lfph
颯	lfsa
鏖	ljao
站	lkvj
韶	lkuc
啻	lkii
耜	lksi
麋	lmmi
辣	lnla
竦	lnss
耘	lsyy
竭	lvjp
耙	lvpa
耙	lvba
麈	lwvu
翊	lyyi
盂	mayu
髦	mamc
糯	mano
粲	macj
槿	majb
柞	mava
杼	mavu
榧	mafw
閂	maur
閘	mava
閻	mayj
閾	mayu
關	magr
闡	maij
椏	maya
椪	mapg
橦	mats
橦	mail
楷	mbkd
楷	mbjp
枳	mbvi
騏	mbqi
驥	mbji
梹	mbbk
槓	mbgh
檳	mbbk
檳	mbbb
櫃	mbju
櫃	mbgv
檠	mcqk
駢	mcpm
騙	mcpm
枅	mcji
榑	mcfu
榑	mcbo
槫	mctr
槫	mcur
槫	mcqr
檮	mctc
檮	mciz
檮	mcdc
梦	mdmg
梵	mdfj
橙	mdig
粱	mdll
楔	mdxp
柢	mddi
柢	mdii
柝	mdto
粢	mdzi
粢	mdci
閼	mdee
闌	mdlj
朮	mduu
杙	mdyi
榿	mdqi
樸	mdpu
樸	mdpo
樸	mdpn
檸	mdnk
毬	mdqq
盜	mddc
盪	mddh
糲	mdli
档	medh
椰	meye
楫	meji
驍	mexn
柮	mevo
槨	mego
橈	merc
橈	menc
楞	mflg
榜	mfbh
枋	mffh
騅	mfvv
櫂	mfyi
櫂	mfvc
權	mfqr
槐	mghk
杠	mggh
栲	mgkc
槎	mgia
騁	mgig
棧	mgvj
毯	mhtj
楸	mhqq
蠱	migu
騷	misc
槧	miqm
桷	mjjt
欖	mjlj
柯	mkke
枷	mkjx
榕	mkrs
槁	mkgc
梏	mkgu
枸	mkju
枸	mkgz
閭	mklv
闊	mkko
駘	mktd
駱	mklo
驅	mkqu
驕	mkjn
鹽	mkyj
梠	mklv
棡	mkgh
樞	mkuu
檣	mkql
櫚	mklv
櫺	mklk
驪	mlli
朸	mlli
橇	mmqn
糅	mmrz
楹	mmyk
毳	mmcv
闔	mmhe
闖	mmil
驢	mmlv
驫	mmbn
楙	mmmc
楪	mmye
楪	mmdp
榲	mmwf
檻	mmkj
檻	mmjm
櫟	mmyt
櫟	mmli
粮	mnll
棣	mnti
棣	mndi
棣	mndd
檬	mnmg
柩	mnjq
椽	mnir
粳	mnjk
楝	mnlm
隸	mnli
駑	mnnu
駛	mnui
驟	mnvz
樓	mnlz
樣	mnyh
櫞	mnyr
櫻	mnyk
楮	moiu
杳	moyc
闍	moue
闍	modu
橢	moto
檜	mohv
檜	mogv
桀	mpjp
盥	mpgr
杪	mpmn
驂	mpcj
鬱	mpyu
粃	mpba
粃	mppa
槊	mquo
闃	mqqu
闕	mqqt
柤	mqva
盒	mrhe
駭	mrhd
驗	mryj
樅	mrzs
樅	mrcs
檢	mrjm
駟	mssi
騾	mslo
欒	mslr
榴	mtlq
桎	mtvi
盍	mthe
閨	mtgv
攀	mupj
杆	mugj
粹	mucv
棹	muvo
棹	muvc
檗	mubo
槲	muhu
駻	muhj
驛	muyi
桿	mugj
棍	mvgy
梳	mvuu
杞	mvqi
椹	mvvf
椹	mvuf
閹	mvyj
駝	mvto
枹	mvbc
梔	mvvi
槃	mvpj
樂	mvyt
樂	mvle
櫪	mvli
盡	mvjb
枉	mwwh
梭	mwso
框	mwkl
橄	mwgj
檄	mwxi
閔	mwmb
馼	mwwf
棕	mxzs
粽	mxzs
槭	mxse
槭	mxqi
驃	mxpn
驃	mxbn
盖	mygd
榻	myta
檐	myyj
栩	myxu
椒	myjn
榱	mycv
馭	myyu
駸	myqb
驤	myxl
椁	mzgo
梃	mztk
桴	mzfu
闥	mzta
靠	nakc
妲	nada
媾	nagz
嬋	naij
鴉	naya
鴦	nayh
鶇	nads
鷯	naln
嬪	nbpb
鶲	nbwg
鸚	nbyk
犢	nbdu
妍	ncyj
鵲	ncqt
鸛	ncgr
姆	ndmu
姚	ndyc
娥	ndee
娑	ndso
妁	nduo
嫋	ndnn
鴆	ndvf
鶺	ndji
牴	nddi
犧	ndxi
娜	neno
娜	nena
娶	nequ
娉	ngpk
鶻	nghu
鶻	nggu
鷓	ngve
嫣	nhyj
犁	nhli
嫦	njih
鳧	njfu
婀	nkee
犒	nkkc
牾	nkwu
嫗	nkyu
嬌	nkjn
鵑	nkjr
鶚	nkee
嬲	nlnn
婪	nmlj
媼	nmao
媽	nmma
嫻	nmxm
梟	nmxn
樢	nmwu
姨	nnyi
嫐	nnnc
鴃	nnjt
犇	nnbf
媚	nomw
娟	nojr
孀	noul
嫺	noxm
鴟	npii
鵝	npee
鵯	npbw
鷽	npxt
鷁	nqyi
鴒	nrlk
鴿	nrge
鵐	nrwu
鷦	nrjn
鶩	nswu
鷸	nsyu
鷙	ntvi
奸	nujm
婢	nubi
嬖	nubi
鴣	nugu
婉	nvwj
妣	nvbi
鴕	nvto
鷂	nvyc
嫩	nwnf
鵁	nwjn
鶉	nwiy
嫖	nxpn
嫂	nysc
娵	nyju
孃	nynl
胖	oaph
胖	oapj
腥	oaxk
暄	oaxr
胚	oapw
腓	oafw
胛	oajx
膈	oage
胙	oazo
膕	oago
臍	oaqi
臑	oanc
顯	oaxm
曄	oaye
瞑	obmk
腆	obtm
暝	obmk
曠	obkl
瞶	obkv
膊	ocbo
腑	ocfu
胼	ocpm
昊	odhc
脯	odpu
脯	odfu
滕	odtg
晁	odic
腋	odye
胝	odvi
肭	odna
膩	odni
睨	oeni
昴	oemc
胱	oegl
曉	oexn
朏	oeku
朏	oefw
膀	ofph
膀	ofbh
瞿	ofqu
瞿	ofju
膂	oflv
晢	ofve
曦	ogxi
胯	ogkx
肛	oggh
脛	ogjk
暈	oiyy
暉	oihv
矚	oivu
晰	ojxi
晞	ojxi
瞎	okxx
晤	okwu
膽	okdj
勗	olxu
朧	olls
杲	omgc
膃	omwa
臚	omlu
脉	onmo
脉	onmd
晨	onif
眸	onmz
朦	onmg
晏	onyj
腴	onyu
曚	onmg
眛	onmw
矇	onmg
矇	onmg
睛	oojk
睹	oodu
膾	ookk
睇	opdi
眇	opmn
膠	opjn
暘	opyh
歇	oqxp
睫	orjp
昃	orze
臉	orlm
瞞	ormj
瞼	orjm
眩	osxr
肚	otdu
瞠	otig
睚	otya
膣	otvi
臂	oubw
臂	oubi
脾	oupi
旱	ouhj
臀	outy
睥	oupi
睥	oubi
瞽	ougu
眈	ovdj
冕	ovmm
昵	ovni
眦	ovzi
晟	ovug
晟	ovig
眄	ovmm
曷	ovhe
臘	ovxi
臘	ovla
眥	ovzi
瞰	owkj
暾	owty
旻	owmb
曖	owai
腮	oxsd
腦	oxnc
暸	oxln
曼	oymj
瞻	oyvj
矍	oyjt
曩	oynh
腱	ozjm
册	pace
袒	patj
祚	pazo
釉	payz
襦	paru
肄	payi
袢	papj
彳	paii
舉	paju
彿	pafu
彿	pafo
潁	payk
禪	pauj
禪	paij
祺	pbqi
褶	pbve
與	pbyu
牘	pbdu
褥	pcru
褊	pcbm
舁	pcyu
禹	pdyu
夭	pdyc
衲	pdna
褂	pdgx
祗	pdvi
禊	pdxi
祓	pdfu
釁	pdxb
奧	pdao
祿	pdlu
禮	pdli
兒	peer
歸	pegv
雕	pfdn
几	pgji
粤	pgyt
炙	phvi
褫	phii
爨	phcr
襁	piql
褌	piky
襯	pjif
覺	pjjt
覺	pjjn
裙	pkqy
祠	pkci
禧	pkxi
牆	pkql
舅	pljq
勳	plxy
褓	pmbc
襤	pmlj
乘	pnug
乘	pnig
秉	pnbk
袂	pnmw
臾	pnyu
夂	pnwf
褸	pnlv
襪	pnwa
襴	pnlj
乂	pnyi
衫	ppuj
裼	ppxi
裼	ppti
袗	ppvf
祕	ppmi
祕	ppbi
袱	pqfu
舐	pqui
歃	pqua
歟	pqyu
黐	psii
襠	ptdh
貍	ptli
鼾	puhj
裨	pupi
裨	pubi
衽	purf
睾	pugc
釋	puui
儿	pver
乖	pvgk
袍	pvpc
祀	pvsi
卮	pvvi
勹	pvbc
皰	pvpc
攵	pxwf
龜	pxqq
龜	pxjy
龜	pxgv
慇	pxyb
殷	pyyb
殷	pyyj
叟	pysz
禳	pyrh
譽	pyyu
毀	pyhv
褪	pzty
褪	pztv
孵	pzfu
狒	qafw
狎	qaxx
狃	qanq
貳	qber
獺	qbta
并	qcbk
犹	qdyz
氛	qdff
剪	qdjm
奠	qddm
弋	qdyi
氤	qdyb
獰	qdnk
猊	qeni
狡	qfjn
猩	qfxk
雎	qfju
飆	qfbn
猾	qghx
戡	qgkj
狄	qhdi
獨	qidu
哭	qkku
猗	qkyi
馘	qkgo
狠	qnhf
猥	qnww
狹	qnxx
猜	qocd
猖	qoih
狷	qojr
獪	qokk
歉	qqqm
獗	qqjt
縣	qsxm
猴	quhz
猝	qucu
斟	quvf
獵	qvlp
翦	qyjm
孳	qzzi
个	rage
佛	rafo
佛	rafu
价	rajx
舒	rauu
僵	rajl
徘	rapd
俑	rays
僮	ravl
僮	rats
俚	rali
徂	racu
儕	raid
頷	rahj
彿	rafu
彿	rafo
彿	rafu
彿	rafo
偕	rbxp
佰	rbbd
價	rbjx
價	rbjp
傅	rcfu
俯	rcfu
龠	rcyt
侖	rcly
傳	rcvr
傳	rcir
儔	rciz
崙	rcly
仆	rdpu
衍	rdyj
衙	rdya
俐	rdli
侈	rdii
仞	rdrf
佻	rdtn
衢	rdqu
衒	rdxr
佇	rdvu
銜	rdxm
倪	reni
僥	reyc
僥	rejn
彷	rfph
彷	rffh
徭	rfyc
隹	rfvv
儺	rfno
糴	rfdi
截	rgjp
傀	rgkv
傀	rggv
倥	rgks
儁	rgjy
雋	rgjy
雋	rgjr
徑	rgjk
儻	rhth
俥	riie
佩	rjpw
伉	rjkh
覦	rjyu
俔	rjqm
舍	rkue
估	rkgu
倚	rkyi
倔	rkjt
徊	rkhk
僖	rkxi
倨	rkju
佝	rkgz
佶	rkji
傴	rkyu
仂	rlle
儷	rlli
龕	rlkj
們	rmmf
儘	rmjb
儘	rmjb
條	rmtn
氣	rmqi
很	rnhf
仗	rnvh
偃	rnyj
侏	rnvu
佞	rnnk
佚	rnyi
佚	rndp
僂	rnlv
僂	rnlz
儂	rnns
徠	rnld
倩	roqm
藉	rojp
藉	roji
倡	roih
徇	roxy
僭	rojm
侑	royz
脩	roxq
脩	roxq
會	rohv
會	rokk
仍	rprg
倏	rquu
俎	rqzu
歙	rqxi
歙	rque
侘	rqia
从	rrcs
徙	rrxi
倆	rrll
僉	rrqm
儉	rrjm
從	rrcs
絛	rstc
儡	rtlw
拿	runa
俟	rusi
俟	ruqi
俾	rubi
仟	ruqm
倬	ruvo
气	rvqi
佗	rvto
毓	rvyu
偈	rvjp
偈	rvji
做	rwzo
傲	rwao
攸	rwyz
徨	rwhl
徼	rwjn
傚	rwxn
儼	rwyj
偬	rxzs
假	ryjx
佯	ryyh
衾	ryqb
翕	ryxi
俶	ryti
俶	ryiu
雙	ryul
俘	rzfu
甬	says
鈕	sanq
紵	savu
絆	sabj
絳	sajl
繻	saxu
纈	saxp
繽	sbbb
續	sbxu
紂	scvz
綸	scly
綸	scgr
縟	scru
罘	sdfu
絎	sdhh
纔	sdcd
緝	seji
繞	serc
罹	sfli
綯	sftc
彎	sgwj
經	sgjk
纖	sgxm
纖	sgqm
綮	shqi
綮	shqk
蜀	siuu
斷	sjdr
纜	sjlj
罟	skgu
紿	skdd
絅	skjs
綢	skiz
綰	skwj
綺	skqi
緘	skjm
紮	smva
綵	smcd
綵	smcd
緤	smye
緤	smxp
縊	smyi
繿	smlj
羈	smji
豫	snyu
絮	snxu
綏	snsv
縷	snlv
纓	snyk
緡	somb
縉	sojb
繃	sobg
繪	sohv
皴	spcy
參	spuf
參	spcj
緲	spmn
繆	spmz
繆	spmq
繆	spmn
欸	sqei
欸	sqai
欸	sqvd
綟	sqli
縱	srzs
紜	ssyy
絲	sssi
縲	sslw
畚	stbf
緇	stzi
罩	suvc
矣	suyi
辮	subm
紆	suyu
絨	surs
綽	suio
綽	suic
繹	suyi
矜	svqb
矜	svjb
矜	svgr
罨	svyj
糺	svjq
紕	svpi
紕	svbi
紲	svxp
綣	svqr
繩	svug
繼	svji
緻	swvi
縹	sxpn
總	sxzs
繚	sxln
詈	syli
緞	sydr
縵	symj
縋	szvv
縺	szlm
墅	tauu
墟	taxu
壑	tahe
堊	taee
壙	tbkl
畴	tciz
坩	tcgj
埒	tclp
塒	tcui
疇	tciz
坏	tdhk
埔	tdpu
埔	tdbu
墮	tehv
墮	tedo
塢	thwu
塹	tiqm
圻	tjyb
圻	tjqi
埆	tjqt
埆	tjjt
畸	tkji
堝	tkgo
壟	tlls
耄	tmmc
壗	tmjb
垠	tnyb
赭	tove
耆	toqi
堋	topg
堋	tobg
坡	tppo
畛	tpvf
坎	tqkj
疊	tqdp
堡	trbc
垓	trgd
垈	trdd
耋	ttdp
堙	ttyb
垤	ttdp
壘	ttlw
埃	tuai
臺	tutd
址	tvvi
堽	tvgh
壅	twys
袁	tyyr
壤	tyrh
赧	tynj
壞	tyhk
翹	tyqn
矗	uaiu
鼬	uayz
邨	uacy
頡	uaxp
頡	uajx
頡	uajp
壺	uahu
壼	uaky
餡	uaxm
屆	uajp
咫	ubvi
饋	ubkv
饌	ubvr
磧	ubqi
礦	ubkl
屏	ucpk
卉	uchv
壽	ucuz
磚	ucvr
碌	udlu
砌	udqi
餮	udtp
壹	udyi
磴	uddg
剋	udkw
剋	udke
飫	udyu
餔	udbu
饑	udji
尨	udph
尨	udmh
尨	udmg
尨	udls
鼕	udds
磑	udww
礒	udyi
礪	udli
兢	uejk
聲	ueug
饒	uerc
磽	ueqn
拜	ufbd
磅	ufph
磅	ufbh
雉	ufvi
挈	ufqp
餃	ufjn
饉	ufjb
躬	uggs
磋	ugco
餞	ugjm
餘	uhyu
屬	uivu
屬	uiuu
斫	ujvo
覿	ujdi
饕	uktc
碚	ukbw
餉	ukxl
劼	uljp
飭	ulii
屎	umui
磔	umve
碼	umma
礫	umli
礬	umfj
矮	unai
碾	unnm
餒	unnw
拏	unna
硼	uopg
餬	uohu
彭	uppg
彭	upbh
掣	upie
礙	urai
礙	urai
攣	uslr
硅	utgv
餾	utlq
摯	utvi
碎	uusv
辜	uugu
磊	uulw
辟	uupi
辟	uubi
磬	uuqk
擘	uubo
闢	uupi
闢	uubi
屁	uvpi
砒	uvpi
碣	uvjp
碣	uvya
尢	uvyz
飩	uvty
懿	uxyi
憙	uxxi
翅	uyii
屐	uyji
轂	uygu
饅	uymj
殼	uyqn
殼	uyke
孱	uzij
孛	uzbw
笨	vabf
筝	vavg
篝	vagz
聿	vayu
亟	vaji
孑	vajp
艟	vais
舳	vavu
肅	vasu
頸	vajk
頸	vagg
屮	vaie
晝	vavz
爭	vavg
箏	vavg
篳	vabi
簫	vaxn
簧	vbhl
貊	vbmo
簀	vbze
簣	vbkv
籟	vbld
彝	vcyi
箝	vcqm
笄	vcji
籌	vciz
癸	vdgv
奚	vdxi
貘	vdmo
厶	vdsi
艤	vdyi
筅	vexm
笙	vfug
舫	vffh
籬	vfli
箜	vgks
齶	vgee
箋	vgjm
籤	vgqm
蠡	vili
蝨	viui
箍	vjgu
覓	vjmi
筧	vjjm
篩	vjud
貂	vkdn
貉	vkmo
貉	vkhe
貉	vkhc
箴	vkvf
笞	vkii
笳	vkjx
舸	vkge
艙	vkch
嚮	vkxl
齒	vkii
齣	vkiu
勦	vljn
勦	vlic
籠	vlls
貅	vmxq
篥	vmli
艫	vmlu
籃	vmlj
隶	vnli
篆	vnvr
艨	vnmg
彖	vntr
廴	vntk
夬	vngk
彙	vnhv
筴	vnjx
篋	vnqp
簍	vnlz
簪	vozj
胥	voxu
艚	vocc
筍	vosy
尸	vpui
尹	vpyb
毋	vpwu
笋	vpsy
豺	vpid
豸	vpvi
笏	vphu
筮	vrui
簽	vrqm
幺	vsyc
籀	vtvz
簇	vucu
篌	vuhz
簟	vudm
辭	vuci
顰	vupb
已	vvyi
爬	vvpa
筵	vvyj
笆	vvba
貔	vvpi
篦	vvbi
笊	vvvc
巛	vvve
亂	vvlr
筱	vwxn
筐	vwkl
篁	vwhl
筌	vwqr
籔	vwuu
艘	vysz
爰	vyyr
發	vyfa
羣	vyqy
篷	vzpg
瑾	wajb
敕	waii
亶	wadj
頏	wahh
顏	wayj
顫	wavj
顫	waij
齊	waqi
齋	wavd
齎	waji
齏	waji
數	wauu
珀	wbpo
贏	wbyk
瑣	wbso
弃	wcqi
瑟	wdse
瑜	wdyu
奕	wdyi
瓷	wdci
孰	wduu
玳	wddd
羸	wdlw
珥	weer
瑶	wfyc
敖	wfao
雍	wfys
雜	wfza
瑤	wfyc
弯	wgwj
瑰	wggv
琥	whhu
稟	whbk
螽	wivs
琿	wihy
琿	wihv
亢	wjkh
珮	wjpw
咎	wkjq
吝	wklb
珞	wklo
珈	wkjx
勍	wlqk
瓏	wlls
毫	wmhc
氈	wmvj
瑪	wmma
琅	wnlh
璞	wnpu
瓔	wnyk
瑁	womc
肓	wohl
玻	wpbo
氓	wqmh
氓	wqmg
亳	wqbo
臠	wrlr
敘	wrxu
斂	wrlm
紊	wswf
變	wsbm
鸞	wslr
琺	wsfa
畋	wttm
璧	wubi
璋	wuvh
甓	wupi
收	wvuz
效	wwxn
瓊	wwqs
甕	wwwg
禀	wxbk
敞	wxih
敝	wxbi
瑙	wxnc
敲	wyqn
裹	wygo
襄	wyxl
瑕	wyxx
袤	wymc
袞	wygy
褻	wyxp
惠	xahv
懦	xano
惺	xaxk
惴	xavv
慵	xays
忸	xanq
怫	xafu
怛	xada
衄	xanv
恆	xahg
惡	xawu
惡	xaee
愃	xaxr
憖	xayb
憚	xadj
憚	xada
怕	xbpa
惧	xbju
忿	xbff
愬	xbso
懶	xblj
懶	xblj
忖	xccy
恃	xcui
懊	xdao
弑	xdui
恣	xdzi
惻	xdce
憑	xdpk
懣	xdmf
懺	xdij
飄	xfpn
懼	xfju
愧	xgkv
愕	xgee
恍	xghl
憔	xhqn
愀	xhqn
黨	xhdh
憮	xhwu
懍	xhlb
忻	xjxb
慚	xjcj
怡	xkyi
恬	xktm
惆	xkiz
恪	xkke
恫	xkds
怙	xkhu
慝	xkte
愴	xkil
憺	xkdj
慟	xlts
棠	xmth
懋	xmmc
悃	xmky
愾	xmxi
愾	xmkd
慄	xmli
慍	xmyy
懈	xnxp
慷	xnkh
悚	xnss
怏	xnyh
慊	xnqp
慊	xnqm
悵	xnih
悽	xnqi
悄	xoqn
恂	xoxy
慘	xpcj
欷	xqxi
怎	xrzf
恁	xrnf
愆	xrqm
慫	xrss
憊	xrbw
戀	xslm
恚	xthv
慳	xtqm
當	xtdh
悍	xuhj
悴	xucv
怦	xupg
忤	xuwu
覃	xutj
覃	xuqb
愨	xuqt
懌	xuyi
惘	xvwh
忱	xvif
怩	xvni
悒	xvyi
愍	xvmb
悗	xvmj
惓	xvqr
斃	xvbi
惶	xwhl
甄	xwvf
愎	xwbi
悛	xwqr
覈	xwhu
覈	xwhe
憫	xwmb
恤	xxxu
憬	xxjk
爻	xxyc
卍	xxwj
惱	xxnc
慓	xxpn
恙	xyyh
懷	xyhk
懾	xyue
悸	xzji
悖	xzbw
慥	xzzc
羞	yaxq
裴	yapw
翡	yafw
霏	yafw
霾	yamd
薑	yajl
誦	yass
諂	yaij
諍	yavg
諱	yahv
謔	yaxt
錏	yaya
霽	yaji
靈	yalk
羶	yauj
羶	yadj
諧	ybxp
讀	ybdz
讀	ybdu
讚	ybzj
酣	ychj
諞	ycpm
羹	ydgg
酊	yddk
醴	ydli
羝	yddi
裝	ydvl
訃	ydfu
訥	ydne
詆	yddi
誂	yddn
誂	ydtn
誡	ydjp
誨	ydhv
謨	ydmo
證	ydvg
譏	ydji
讒	ydij
霓	yeni
霍	yfho
諷	yffg
謗	yfbh
謠	yfyc
讎	yfiz
讎	yfqq
戮	yglu
戳	ygio
羲	ygxi
訌	yghs
訖	ygqi
諤	ygee
讖	ygif
酥	yhsu
醺	yhxy
燮	yhxp
詼	yhhv
讌	yhyj
諢	yihy
霈	yjpw
觀	yjgr
鯱	yjhu
裔	ykyi
酩	ykmk
訶	ykhe
詁	ykgu
詒	ykyi
詒	ykdd
詬	ykgz
誥	ykgc
謫	ykve
謳	ykou
譎	ykjt
醫	ykyi
勠	yllu
霖	ymlb
醯	ymxi
醢	ymhd
諡	ymui
謐	ymmi
謚	ymui
譟	ymzc
姜	ynjl
霎	ynua
醵	ynju
誄	ynlw
誅	ynvu
諛	ynyu
諫	ynjm
釀	ynnl
霸	yoba
霄	yoxn
醋	yocu
詢	yoxy
誚	yoqn
諳	yoan
譖	yozf
冑	yovz
鰆	yoiy
醪	yplc
訝	ypya
詛	yqzu
誣	yrwu
羚	yslk
醉	yuzv
霹	yupi
譬	yupi
謦	yuqi
霪	yuyb
襞	yubi
訐	yujp
譚	yutj
譯	yuyi
辯	yubm
羌	yvql
羯	yvjp
雹	yvbc
訛	yvee
詭	yvgv
靂	yvli
靄	yvai
霰	ywxm
酲	ywig
誑	ywkl
謖	ywsu
靉	ywai
黴	ywmw
鱇	yxkh
翔	yyxl
謾	yymj
譫	yyvj
讓	yyrh
霆	yztk
諄	yzvy
譴	yzqm
靆	yzdd
迪	zadi
蹈	zadc
孺	zaru
踵	zavs
跚	zauj
赳	zajq
逑	zaqq
逋	zabu
遘	zagz
蹕	zabi
躋	zaji
逕	zajk
邇	zaer
邀	zbyc
邃	zbsv
遑	zbhl
躓	zbvi
蹲	zcdy
躊	zciz
邁	zcmd
跋	zdba
迢	zdtn
蹊	zdxi
蹊	zdqi
遙	zdyc
躑	zevi
躡	zenp
遨	zfao
躪	zflb
蹉	zgco
跫	zgqs
踐	zgjm
遽	zhju
逶	zhww
躅	zivu
邂	zjxp
逞	zkig
踞	zkju
迥	zkjs
跖	zkvi
踟	zkii
跏	zkjx
跼	zkju
蹌	zkql
迴	zkhv
迴	zkhv
踴	zlys
躁	zmzc
蹂	zmrz
跟	zngf
跌	zndp
踉	znll
踝	znhk
趺	znfu
蹼	znpu
孥	znnu
遏	zoee
躇	zoiu
暹	zoxm
趙	zovc
趁	zpif
跛	zpbo
逅	zphz
跣	zpxm
遞	zpdi
邊	zpbm
學	zpxt
迸	zqbg
蹶	zqjt
逖	zqti
遒	zqqq
孩	zrhd
逾	zryu
蹣	zrpj
蹤	zrzs
邏	zslo
逵	ztkv
躔	ztij
遲	zuii
跪	zvgv
趾	zvvi
遐	zvxx
孚	zvfu
迹	zwji
逡	zwqy
踪	zxzs
逍	zxxn
迺	zxnd
跂	zyqi
#other
车	aaie
车	aaju
业	aaye
亚	aaya
顿	aady
临	aalb
颗	aake
丰	aafg
韦	aaww
颊	aajx
鳞	aalb
顷	aaqk
颅	aalu
韬	aatc
鲤	aali
麴	aaqu
甭	aabg
丌	aaji
卣	aayz
顸	aahj
鲱	aafw
芈	aami
鳙	aays
艹	aacc
鲚	aaji
卌	aaxi
韝	aagz
頇	aahj
頰	aajx
奡	aaao
鮞	aaer
鱅	aays
鱭	aaji
鲕	aaer
麵	aamm
羋	aami
赖	abld
鬓	abbb
鲼	abff
賴	abld
鮊	abbo
鮊	abba
鱝	abff
鲌	abbo
鲌	abba
皕	abbi
开	ackd
鲟	acxy
鳟	aczy
鳊	acbm
鲋	acfu
鲥	acui
鯿	acbm
鰣	acui
鱘	acxy
两	adll
东	adds
丽	adli
卡	adka
卡	adqx
专	advr
韧	adrf
枣	adzc
鲨	adua
鱿	adyz
鳏	adgr
毖	adbi
鲡	adli
戋	adjm
鲅	adba
鳢	adli
內	adnw
韌	adrf
奀	adnf
奀	aden
魷	adyz
鮁	adba
归	aegv
尧	aeyc
兕	aesi
鳕	aext
鲫	aeji
鲵	aeni
髡	aeky
鲩	aehr
䲟	aeyb
鮣	aeyb
鯇	aehr
鯽	aeji
鳌	afao
鲛	afjn
鳐	afyc
鲂	affh
鰩	afyc
战	agvj
戬	agjm
鳄	agee
鹾	agco
丏	agmm
鹺	agco
戩	agjm
灭	ahmp
稣	ahsu
鳅	ahqq
鬏	ahjq
穌	ahsu
严	aiyj
虺	aihv
虿	aiid
鲺	aiui
鯴	aiui
鰠	aisc
鳋	aisc
师	ajui
规	ajgv
帅	ajuk
觇	ajij
击	akji
吞	akty
鳝	akuj
鲇	aknm
鲷	akdn
鲒	akjp
鲐	aktd
軎	akie
鮐	aktd
鮚	akjp
鯝	akgu
鱔	akuj
鱷	akee
鲴	akgu
鳓	alle
劢	almd
勔	almm
鰳	alle
鱺	alli
桌	amvo
橐	amto
韫	amyy
韫	amwf
鲽	amdp
髹	amxq
鲦	amtn
韞	amyy
韞	amwf
鰷	amtn
棐	amfw
夹	anjx
夹	anga
耍	anux
鸯	anyh
鲠	angg
嫠	anli
伕	anfu
嫑	anmq
嫑	anbc
鯁	angg
犛	anli
犛	anmc
鲁	aolu
鳍	aoqi
鲳	aoih
鲔	aoww
鲭	aoqk
鬍	aohu
鯧	aoih
畅	apih
耏	apnd
耏	aper
欤	aqyu
鳜	aqjt
鳜	aqgv
鱖	aqjt
鱖	aqgv
丛	arcs
鳘	armb
鯷	arti
鰵	armb
鳀	arti
鹼	arjm
紧	asjb
鲧	asgy
鲑	atxp
鲑	atgv
鲣	atjm
鲻	atzi
坒	atbi
卢	aulu
凿	auzc
鲈	aulu
鲆	aupk
电	avdm
丝	avsi
毙	avbi
鲍	avbc
鲲	avky
鬈	avqr
乩	avji
巰	avqq
鲮	awlk
鳆	awfu
鳇	awhl
鯪	awlk
尫	awwh
鲸	axjk
卤	axlu
鳖	axbp
鬃	axzs
鳃	axsd
鲶	axnm
鳔	axbn
鱉	axbp
慭	axyb
鲜	ayxm
囊	aynh
翘	ayqn
鳗	aymj
鲰	ayzz
鳎	ayta
翮	ayhe
䎃	ayrj
鯗	ayxl
鯫	ayzz
鰨	ayta
孬	aznc
趸	azdy
鲢	azlm
鰱	azlm
单	badj
单	bauj
单	baij
贵	bagv
额	baee
丫	baya
审	bauf
疗	baln
贤	baxm
窜	bacr
页	baye
贞	bavf
颁	babj
颂	bass
癫	badm
痹	babi
贮	bavu
甯	bank
疟	bayc
疟	bant
痈	bays
痱	bafw
鲞	baxl
赉	bald
瘅	badj
痄	bava
癃	bals
痖	baya
宧	bayi
瘂	baya
癉	badj
赛	bbsd
贫	bbpb
宾	bbbb
癞	bbld
癀	bbhl
赑	bbbi
赙	bcfu
贳	bcui
癟	bcbp
实	bdui
资	bdzi
负	bdfu
宁	bdnk
窝	bdwo
赋	bdfu
赎	bduu
窦	bddz
宓	bdmi
宓	bdfu
瘀	bdyu
瘌	bdla
甯	bdnk
穸	bdxi
瘼	bdmo
窬	bdyu
赆	bdjb
賕	bdqq
赇	bdqq
寬	bdkr
宪	bexm
兑	bedv
贶	bekl
疖	bejp
貺	bekl
冚	bekj
癤	bejp
责	bfze
疯	bffg
瘫	bftj
窑	bfyc
赘	bfvv
贽	bfvi
癯	bfqu
癱	bftj
贡	bggs
贱	bgjm
窍	bgqn
疙	bgge
痉	bgjk
窳	bgyu
瘥	bgid
瘥	bgcd
戭	bgyj
㿠	bghl
灾	bhzd
賧	bhdj
赕	bhdj
军	bijy
瘙	bisc
宽	bjkr
帘	bjlm
窥	bjkv
幂	bjmi
宄	bjgv
员	bkyr
宫	bkgs
兽	bkuz
贴	bktp
赔	bkpw
瘩	bkda
赂	bklu
贻	bkyi
疴	bkke
痦	bkwu
賙	bkvz
賙	bkvz
赒	bkvz
穷	blqs
贺	blhe
宠	blis
痨	bllc
疬	blli
骞	bmqm
痫	bmxm
桊	bmjr
冧	bmlf
寀	bmcd
赞	bnzj
赚	bnvr
赚	bnzj
账	bnvh
贬	bnbm
痪	bnhr
赈	bnvf
瘐	bnyu
瘿	bnyk
窠	bnke
瘘	bnlz
窭	bnju
冁	bnij
窆	bnbm
瘃	bnvu
賬	bnvh
瘓	bnhr
癭	bnyk
赌	bodu
赠	bozg
贿	bohv
窨	boyb
窨	boxy
财	bpcd
贸	bpmc
赐	bpci
疡	bpyh
皲	bpjy
疠	bpli
瘳	bpiz
痧	bpua
皂	bqzc
货	brho
贪	brtj
贷	brdd
瘸	brqt
赁	brlb
赅	brgd
賅	brgd
寁	brzj
购	bsgz
赃	btzh
痤	btco
皤	btpo
瘗	btyi
瘞	btyi
贼	buzw
掰	bubd
贲	bubi
贲	bubf
赍	buji
瘊	buhz
屃	buxi
皁	buzc
窣	busu
费	bvfw
贯	bvgr
疤	bvba
疮	bvil
瘪	bvbp
皑	bvai
赀	bvzi
窀	bvvy
宬	bvig
癍	bwbj
疰	bwvu
攽	bwbj
瓫	bwpg
痠	bwsr
癥	bwvg
赏	bxuh
贾	bxjx
贾	bxgu
瘾	bxyb
赊	bxue
癔	bxyi
瘵	bxvd
瘛	bxii
賒	bxue
瘭	bxbn
癮	bxyb
瘦	byuz
贩	byfj
翱	byao
赡	byuj
誊	bytg
癣	byxr
褰	byqm
瘕	byxx
瘕	byjx
䎖	byzg
萧	caxn
苇	caww
苯	cabf
堇	cajb
颧	caqr
蕤	carv
荞	caqn
荠	caqi
荠	caji
苎	cavu
蘼	cami
萏	cadj
蕺	caji
蓣	cayu
颟	camj
苤	capp
薷	caru
莶	caxm
莶	calm
茀	cafu
茽	cavs
荁	cahr
萚	cato
蓽	cabi
顢	camj
萁	cbqi
蒉	cbkv
蒉	cbkk
蒇	cbij
蕻	cbhs
茓	cbxt
葓	cbhs
蒈	cbkd
蓂	cbmk
蕆	cbij
蕒	cbmd
蕢	cbkv
蕢	cbkk
藠	cbjn
黃	cbhl
莳	ccui
薅	cchc
苷	ccgj
荨	ccxy
荨	ccqm
葑	ccfg
荓	ccpk
荮	ccvz
萹	ccbm
葤	ccvz
蔣	ccjl
药	cdyc
苏	cdsu
萝	cdlo
蘅	cdhg
蓟	cdji
荥	cdyk
荥	cdxk
莆	cdpu
荇	cdxk
菸	cdyj
荩	cdjb
茇	cdba
莴	cdwo
芄	cdwj
菝	cdba
莸	cdyz
葶	cdtk
苄	cdbm
葜	cdqx
荬	cdmd
芃	cdpg
茋	cdvi
莿	cdci
菂	cddi
菉	cdlu
薁	cdyu
薴	cdvu
薴	cdnk
节	cejp
荛	cerc
茺	ceis
蔸	cedz
苉	cepi
茚	ceyb
䓛	cequ
䓛	cegu
䓛	cefu
薌	cexl
蔺	cflb
萑	cfhr
茭	cfjn
藿	cfho
蕹	cfwg
蒱	cfpu
䓨	cfyk
蘺	cfli
艺	cgyi
芎	cgxs
荭	cghs
茳	cgjl
葒	cghs
葴	cgvf
蓏	cglo
藭	cgqs
薰	chxy
荧	chyk
蔫	chnm
蘸	chvj
菼	chtj
藨	chpc
藨	chbn
𦼖	chlm
萨	cisa
萤	ciyk
茧	cijm
荤	cihy
蔃	ciql
蠆	ciid
苋	cjxm
觐	cjjb
蕲	cjqi
芾	cjfw
芾	cjfu
蓥	cjyk
艽	cjqq
艽	cjjn
菥	cjxi
莧	cjxm
蘄	cjqi
觏	cjgz
营	ckyk
蔷	ckql
蓓	ckbw
菇	ckgu
菡	ckhj
茁	ckvo
莒	ckju
苕	ckuc
苕	cktn
菏	ckhe
茼	ckts
萜	cktp
苘	ckqk
茝	ckid
莙	ckjy
䓫	ckqi
劳	cllc
荔	clli
茏	clls
苈	clli
葧	clbo
蒞	clli
䓖	clqs
勚	clyi
勩	clyi
勱	clmd
蓝	cmlj
荣	cmrs
蓦	cmmo
蕴	cmyy
蕖	cmqu
芼	cmmc
蕰	cmyy
藎	cmjb
棻	cmff
莺	cnyk
荦	cnlo
葳	cnww
荑	cnyi
荑	cnti
荚	cnjx
苌	cnih
芨	cnji
茑	cnnn
蒌	cnlz
荽	cnsv
茛	cngf
蒎	cnpd
萊	cnld
蒗	cnlh
蔞	cnlz
薢	cnxp
荫	coyb
瞢	comg
蒴	couo
葙	coxl
蒨	coqm
蓇	cogu
蓢	colh
荡	cpdh
芴	cpwu
芴	cphu
艿	cpnd
芗	cpxl
苾	cpbi
荖	cplc
获	cqho
芪	cqqi
莰	cqkj
蔌	cqsu
芡	cqqm
菹	cqzu
甙	cqdd
苠	cqmb
葖	cqtu
芮	crrv
苁	crcs
蓰	crxi
荄	crgd
萣	crdk
蓯	crcs
薟	crxm
薟	crlm
薿	crni
萦	csyk
荟	cshv
蓠	csli
蘩	csfj
蓀	cssy
蕓	csyy
蕓	csyy
茬	ctia
茔	ctyk
芏	ctdu
莝	ctco
藟	ctlw
芊	cuqm
蘑	cumo
摹	cumo
蒺	cuji
莘	cuxb
莘	cuuf
茕	cuqs
荜	cubi
茌	cuii
莛	cutk
菪	cudh
萆	cubi
萳	cunj
䓬	cuvo
蔊	cuhj
藦	cumo
蘀	cuto
斠	cujn
苍	cvch
芷	cvvi
蔼	cvai
芜	cvwu
芩	cvqb
菀	cvyy
菀	cvwj
茈	cvzi
茈	cvci
芑	cvqi
葚	cvuf
芘	cvpi
芘	cvbi
莼	cviy
芤	cvkz
苊	cvee
藶	cvli
莹	cwyk
荃	cwqr
莜	cwyz
芠	cwwf
葰	cwjy
蔹	cwlm
蘞	cwlm
蕙	cxhv
荪	cxsy
萘	cxnd
葸	cxxi
薏	cxyi
蒽	cxen
芣	cxfu
菍	cxrf
菍	cxnp
蔈	cxbn
蔥	cxcs
薸	cxpn
蔻	cykz
藓	cyxm
菔	cyfu
芰	cyji
蕞	cyzv
蘘	cyrh
莲	czlm
孽	cznp
蘧	czqu
莩	czfu
荸	czbi
荙	czda
薘	czda
薳	czyr
薳	czww
躉	czdy
顶	dadk
济	daji
鱼	dayu
泽	daze
净	dajk
渔	dayu
潇	daxn
泻	daxp
濒	dabb
渲	daxr
殛	daji
殓	dalm
灏	dahc
殚	dadj
洹	dahr
瀣	daxp
滹	dahu
澶	daij
泮	dapj
洚	dajl
渖	dauf
滏	dafu
氵	dauv
淠	dapw
淠	dapi
濞	dapi
濞	dabi
涠	daww
剅	dalz
剕	dafw
夼	dakl
殭	dajl
汈	dadn
汫	dajk
潷	dabi
潿	daww
澦	dayu
灝	dahc
灝	dahc
则	dbze
溃	dbkv
滨	dbbb
渍	dbzi
濑	dbld
殒	dbyy
滇	dbdm
殡	dbbb
潢	dbhl
潢	dbgl
剜	dbwj
浈	dbvf
瀵	dbff
奭	dbui
涢	dbyy
湞	dbvf
溳	dbyy
滪	dbyu
瀆	dbdu
瀨	dbld
夺	dcdo
荆	dcjk
蒯	dckk
澍	dcuu
澍	dcvu
浔	dcxy
漭	dcmh
泔	dcgj
瀹	dcyt
劐	dcho
剒	dcco
汧	dcqm
洴	dcpk
㽏	dcgj
头	ddtz
满	ddmj
测	ddce
奖	ddjl
凑	ddcz
冻	ddds
泼	ddpo
澜	ddlj
浆	ddjl
浏	ddlq
渎	dddu
淼	ddmn
汴	ddbm
泞	ddnk
涮	ddur
沏	ddqi
澧	ddli
洮	ddtc
洇	ddyb
沭	dduu
渌	ddlu
汊	ddia
泺	ddlo
湔	ddjm
沩	ddww
剦	ddyj
奓	ddva
奓	ddue
奓	ddii
毚	ddij
汋	ddvo
汋	ddqt
汍	ddwj
汭	ddrv
沊	dddj
淥	ddlu
灃	ddfg
㳚	ddyu
浇	dejn
耷	deda
沅	deyr
洱	deer
刍	deiu
泖	demc
冼	dexm
剀	dekd
刿	degv
奅	depc
沇	deyj
灄	deue
㓥	deth
㳘	deis
滩	dftj
雏	dfiu
沣	dffg
潍	dfww
濉	dfsv
殣	dfjb
渢	dffg
滻	dfij
濰	dfww
灕	dfli
门	dgmf
划	dghx
污	dgwu
溅	dgjm
刨	dgpc
刨	dgbc
泾	dgjk
汔	dgqi
豇	dgjl
冮	dggh
刬	dgij
剗	dgij
氹	dgtf
氹	dgdh
涇	dgjk
涂	dhtu
沪	dhhu
沪	dhlv
滁	dhiu
剡	dhyj
剡	dhuj
溱	dhvf
溱	dhqb
溈	dhww
滎	dhyk
滎	dhxk
潙	dhww
浑	dihy
浊	divo
劂	dijt
浐	diij
沉	djif
渐	djjm
剁	djdo
钊	djvc
沆	djhh
浠	djxi
澌	djsi
釗	djvc
凘	djsi
氿	djjq
氿	djgv
浉	djui
溮	djui
灠	djlj
别	dkbp
刚	dkgh
减	dkjm
洁	dkjp
汇	dkhv
汹	dkxs
漪	dkyi
潞	dklu
剐	dkgx
涪	dkfu
洄	dkhv
涫	dkgr
浯	dkwu
剮	dkgx
呇	dkqi
夠	dkgz
泂	dkjs
泃	dkju
泇	dkjx
浛	dkhj
湉	dktm
漚	dkou
沥	dlli
涝	dllc
夯	dlhh
泷	dlul
泷	dlls
泐	dlle
剷	dlij
澇	dllc
冯	dmpk
冯	dmfg
滥	dmlj
涤	dmdi
溧	dmli
滦	dmlr
湓	dmpf
滗	dmbi
凓	dmli
溫	dmwf
濼	dmlo
灤	dmlr
灩	dmyj
农	dnns
浓	dnns
牵	dnqm
鸿	dnhs
涨	dnvh
妆	dnvl
涣	dnhr
奂	dnhr
浃	dnjx
涿	dnvo
涞	dnld
涑	dnsu
漤	dnlj
沬	dnmw
淶	dnld
涧	dojm
湄	domw
汩	doyu
汩	dogu
灞	doba
刖	doyt
洧	doww
潲	douc
洎	doji
澮	dokk
澮	dohv
皱	dpvz
汤	dpth
涉	dpue
渗	dpuf
删	dpuj
殇	dpuh
劓	dpyi
沘	dpbi
澩	dpxt
殂	dqcu
溴	dqxq
洑	dqfu
淚	dqlw
狀	dqvl
㵐	dqjt
剑	drjm
创	dril
涡	drwo
涡	drgo
漩	drxr
刽	drgv
劁	drqn
劊	drgv
殮	drlm
湜	drui
沟	dsgz
泠	dslk
泫	dsxr
潆	dsyk
漯	dsta
漯	dslw
漯	dslo
凇	dsss
浍	dskk
浍	dshv
沄	dsyy
瀠	dsyk
奋	dtff
洼	dtwa
淄	dtzi
𠝹	dtjp
溼	dtui
瀍	dtij
户	duhu
剧	duju
歼	dujm
汛	duxy
漳	duvh
浒	duxu
浒	duhu
泸	dulu
淖	duvo
淖	dunc
淖	duio
汙	duwu
㓤	duji
渴	dvke
涩	dvse
龟	dvqq
龟	dvjy
龟	dvgv
沧	dvch
沦	dvly
涔	dvcf
汜	dvsi
溉	dvgd
滟	dvyj
沔	dvmm
刭	dvjk
渑	dvug
渑	dvmm
淝	dvfw
沲	dvdo
浼	dvmw
剝	dvbo
剝	dvbc
劄	dvva
劌	dvgv
浥	dvyi
澠	dvug
澠	dvmm
灧	dvyj
刘	dwlq
润	dwry
剂	dwji
澈	dwie
滢	dwyk
玺	dwxi
潋	dwlm
汶	dwwf
汶	dwmf
澉	dwgj
淩	dwlk
漵	dwxu
瀅	dwyk
尔	dxer
沪	dxhu
沪	dxlv
滤	dxlv
奁	dxlm
沤	dxou
漶	dxhr
剎	dxua
剎	dxia
劏	dxth
劏	dxts
沨	dxfg
淴	dxhu
㓥	dxth
㳇	dxfu
㴔	dxyi
㴔	dxse
汉	dyhj
滚	dygy
詹	dyvj
殁	dymo
豉	dyii
溻	dyta
溆	dyxu
滠	dyue
剟	dydo
潑	dypo
涟	dzlm
浞	dzvo
	dzda
澾	dzda
㳠	dzda
卫	eaww
险	eaxm
阶	eajp
顽	eawj
邮	eayz
阱	eajk
邢	eaxk
巅	eadm
屿	eayu
峥	eavg
邺	eaye
郦	eavi
郦	eali
鄢	eayj
嶙	ealb
颛	eavr
聃	eadj
郏	eajx
邳	eapi
邴	eabk
峄	eayi
峤	eaqn
峤	eajn
邗	eahj
亍	eaiu
豳	eabb
邶	eabw
郅	eavi
颞	eanp
亓	eaqi
阼	eazo
耑	eadr
郟	eajx
鄴	eaye
酈	eavi
酈	eali
顓	eavr
岞	eazo
峘	eahr
崄	eaxm
嵖	eaia
巔	eadm
职	ebvi
陨	ebyy
郸	ebdj
聩	ebkv
郓	ebyy
聵	ebkv
邠	ebbb
鄆	ebyy
嶍	ebxi
寻	ecxy
鄞	ecyb
岍	ecqm
䢼	ecgs
崶	ecfg
嶟	eczy
联	edlm
陈	edif
岁	edsv
邹	edzz
嵛	edyu
岽	edds
聍	ednk
耵	eddk
聤	edtk
卲	educ
隩	edyu
隩	edao
峂	edts
峛	edli
㠇	edjq
酆	eefg
岿	eekv
峁	eemc
鄹	eezz
阢	eeww
阢	eewu
䢺	eeiu
屼	eewu
屾	eeuf
峣	eeyc
岚	eflj
邡	effh
聱	efao
峧	efjn
亏	egkv
崆	egks
邝	egkl
郇	egxy
郇	eghr
陉	egxk
邛	egqs
鄺	egkl
陘	egxk
隉	egnp
嵅	eghj
嶲	egxi
嶲	egjr
嶲	eggv
巇	egxi
灵	ehlk
郯	ehtj
阵	eivf
崒	eizu
崒	eicv
凯	ejkd
崭	ejvj
觊	ejji
岘	ejxm
峴	ejxm
巋	ejkv
陆	eklu
陆	eklq
峒	ekts
峒	ekds
郧	ekyy
岢	ekke
郾	ekyj
崮	ekgu
岣	ekgz
岵	ekhu
阽	ekdm
鄖	ekyy
喐	ekyu
岠	ekju
峿	ekwu
崌	ekju
崡	ekhj
嶠	ekqn
嶠	ekjn
嶦	ekvj
嶦	ekuj
㞹	ekke
㟃	eksi
动	elds
陇	ells
崂	ellc
鄣	elvh
嶗	ellc
嵘	emrs
粜	emtn
嵲	emnp
嶸	emrs
櫱	emnp
陕	enuj
崴	enww
崴	enwd
郜	engc
嵊	enug
崃	enld
嵝	enlz
崾	enyc
崀	enlh
崍	enld
崬	ends
嶁	enlz
㠓	enmg
阳	eoyh
阴	eoyb
峋	eoxy
崤	eoxn
嵴	eoji
嶒	eocg
邬	epwu
鄱	eppo
岈	epya
邾	epvu
郫	eppi
鄔	epwu
卬	epyh
卬	epah
嶨	epxt
郑	eqvg
崁	eqkj
嵚	eqqb
嶔	eqqb
队	erdv
耸	erss
陡	erdz
邻	erlb
郐	erkk
郐	ergv
陔	ergd
郃	erhe
鄶	erkk
鄶	ergv
岭	eslk
崧	esss
邰	estd
嵫	eszi
郝	ethc
陧	etnp
嶓	etbo
陴	eupi
嶧	euyi
岂	evqi
鼋	evyr
崦	evyj
屺	evqi
岜	evba
郿	evmw
鄉	evxl
鄧	evdg
峗	evww
崿	evee
嵁	evvj
嵁	evkj
黿	evyr
邙	ewmh
隐	exyb
际	exji
聪	excs
岗	exgh
岖	exqu
郗	exxi
鄄	exjr
隳	exhv
隳	exdo
郄	exqp
郄	exxi
䣘	exth
邓	eydg
聂	eynp
酃	eylk
鄯	eyuj
鼗	eytc
叆	eyai
彟	eyho
彠	eyho
崞	ezgo
叇	ezdd
拥	fays
择	favd
择	faze
扭	fanq
挣	favg
挤	faji
捡	fajm
掐	faqx
捅	fats
掸	fauj
掸	fadj
撺	facr
撷	faxp
擤	faxk
揎	faxr
揸	fava
挢	fajn
拃	fava
掙	favg
搣	famp
搣	fami
摏	fais
摑	fago
撣	fauj
撣	fadj
擷	faxp
损	fbsy
扒	fbpa
扒	fbba
攒	fbzj
攒	fbcr
飓	fbju
罂	fbyk
掼	fbgr
摈	fbbb
捵	fbdm
捵	fbnm
摜	fbgr
攢	fbzj
攢	fbcr
㨢	fbbo
拼	fcpb
拚	fcpb
捋	fclv
捋	fclo
摒	fcbk
撙	fczy
挦	fcxm
掄	fcly
撏	fcxm
扑	fdpu
执	fdvi
爹	fddp
扰	fdrc
拨	fdbo
揍	fdzz
拧	fdnk
拣	fdjm
搀	fdij
抟	fdtr
拤	fdqx
捯	fddc
揳	fdxp
揼	fddy
揼	fddj
擰	fdnk
攙	fdij
旐	fdvc
㧑	fdww
爷	feye
挡	fedh
扫	fesc
挪	feno
掷	fevi
捣	fedc
挠	fenc
嶅	feao
抌	fevf
搊	feiz
摇	ffyc
摊	fftj
攉	ffho
搒	ffpg
搒	ffbh
扩	fgko
挖	fgwa
挎	fgkx
搲	fgwa
护	fhhu
揪	fhjq
飚	fhbn
摭	fhvi
搋	fhik
飈	fhbn
掞	fhyj
掞	fhuj
撝	fhww
罃	fhyk
挥	fihv
搔	fisc
撵	finm
攆	finm
带	fjdd
搅	fjjn
揽	fjlj
靓	fjll
靓	fjjk
靚	fjll
靚	fjjk
搞	fkgc
捂	fkwu
搁	fkge
掂	fkdm
旖	fkyi
撂	fkln
搪	fkth
掊	fkpz
捃	fkjy
颳	fkgx
摳	fkkz
撟	fkjn
撾	fkwo
撾	fkvx
擓	fkkk
㧟	fkkk
拢	flls
捞	fllc
掳	fllu
拋	flpc
擄	fllu
攏	flls
捆	fmky
撬	fmqn
搡	fmsh
扪	fmmf
搽	fmia
揲	fmue
豔	fmyj
掹	fmmg
揾	fmwf
搵	fmwf
擝	fmmg
换	fnhr
搂	fnlz
撄	fnyk
揠	fnya
搛	fnjm
搌	fnvj
摟	fnlz
攔	fnlj
攖	fnyk
捎	fouc
撸	folu
搠	fouo
掮	foqm
揞	foyj
揞	foye
揞	foan
掤	fobf
揗	fouy
揹	fobw
揹	fobw
擼	folu
㨘	foxk
扬	fpyh
扔	fprg
拽	fpvk
掺	fpxm
掺	fpuj
掺	fpij
颺	fpyh
飏	fpyh
摻	fpxm
摻	fpuj
摻	fpij
撐	fpig
抿	fqmb
撅	fqjt
揿	fqqb
扺	fqvi
挓	fqva
撳	fqqb
拟	frni
靛	frdm
抦	frbk
撿	frjm
摆	fsbd
拦	fslj
拎	fslb
攥	fszr
摞	fslo
摛	fsii
搐	ftiu
捱	ftai
擋	ftdh
撑	fuig
摔	fuuk
捱	fuai
抨	fupg
罄	fuqk
捭	fubd
擀	fugj
扦	fuqm
擗	fupi
砉	fuxu
砉	fuhx
䂮	fult
捽	fuzo
撢	fudj
攛	fucr
㩧	fubo
罈	futj
抢	fvql
抢	fvig
爸	fvba
抚	fvfu
拖	fvto
艳	fvyj
扯	fvie
揭	fvqi
揭	fvjp
抡	fvly
旎	fvni
挹	fvyi
飑	fvbn
颮	fvbn
扽	fvdf
揕	fvvf
摴	fviu
撇	fwpp
拴	fwur
拄	fwvu
擞	fwsz
撖	fwhj
抆	fwmf
抆	fwwf
擻	fwsz
摁	fxen
抠	fxkz
掭	fxtm
摅	fxuu
摽	fxbn
攄	fxuu
㩒	fxqb
报	fybc
摄	fyue
摄	fynp
扳	fybj
飕	fysz
掇	fydo
攮	fynh
擐	fyhr
颼	fysz
擭	fyho
㧐	fyss
㩳	fyss
挞	fzta
挝	fzwo
挝	fzvx
擿	fzvi
擿	fzvd
擿	fzti
旞	fzsv
㨃	fzig
㨃	fzdv
应	gayk
项	gaxl
习	gaxi
弹	gatj
弹	gadj
庙	gamn
刁	gadn
匀	gayy
鞒	gaqn
廑	gajb
廑	gaqb
鞲	gagz
骱	gajp
勻	gayy
庼	gaqk
廎	gaqk
⺕	gaji
赓	gbgg
髌	gbbb
賡	gbgg
髕	gbbb
髒	gczh
庤	gcvi
廙	gcyi
够	gdgz
庆	gdqk
废	gdfw
巩	gdgs
魉	gdll
骶	gddi
髖	gdkr
弪	ggjk
戤	gggd
骻	ggkx
魆	ggxu
廆	ggww
廆	gghv
廆	gggv
弳	ggjk
庐	ghlu
韉	ghjm
强	giql
强	gijl
库	giku
辉	gihv
䗪	give
靳	gjjb
髋	gjkr
骷	gkku
髂	gkqx
骺	gkhz
鞀	gktc
鞽	gkqn
弨	gkic
庞	glph
龐	glph
庥	gmxq
张	gnvh
鹰	gnyk
髅	gnlz
庹	gnto
庾	gnyu
髁	gnke
瓞	gndp
魈	goxn
麽	gsmo
厾	gsdu
廕	gsyb
庳	gubw
靶	gvba
乜	gvnp
乜	gvmp
鼐	gvnd
庑	gvwu
庀	gvpi
鞔	gvmj
鞔	gvmf
㐖	gvji
廒	gwao
庱	gwig
廪	gxlb
尕	gxga
弶	gxjl
彆	gxbp
訇	gyhs
庋	gygv
廄	gyjq
廋	gysz
弢	gytc
鞑	gzda
鞯	gzjm
鞬	gzjm
种	havs
种	hais
黑	hahw
烦	hafj
焰	hayj
颓	hatv
炜	haww
煊	haxr
烀	hahu
虛	haxu
頹	hatv
烜	haxr
煒	haww
燁	haye
㶲	hays
㸆	hakc
㸌	haho
积	hbji
炽	hbii
熠	hbyi
烘	hbhs
稹	hbvf
煸	hcbm
爝	hcjt
炼	hdlm
煞	hdua
烁	hduo
烫	hdth
秽	hdhv
烬	hdjb
黩	hddu
黟	hdyi
菸	hdyj
秫	hduu
扅	hdyi
燙	hdth
烧	heuc
灿	hecj
嵇	heji
烷	hewj
稅	heuv
热	hfre
焘	hftc
焘	hfdc
爟	hfgr
缹	hffz
烤	hgkc
烃	hgtk
戱	hgxi
烴	hgtk
焱	hhyj
黧	hhli
扊	hhyj
熒	hhyk
㷫	hhhk
烛	hivu
秃	hjtu
觑	hjqu
炕	hjkh
烯	hjxi
虤	hjyj
覷	hjqu
启	hkqi
秸	hkjp
焓	hkhj
穑	hkse
熵	hkuh
焐	hkwu
扃	hkjs
扂	hkdm
烚	hkxx
焗	hkju
熗	hkql
稆	hklv
稖	hkpw
虏	hllu
煜	hlyu
棨	hmqi
檾	hmqk
燊	hmuf
焕	hnhr
煨	hnww
炔	hnqt
稞	hnke
稂	hnlh
燶	hnns
秾	hnns
穠	hnns
㶶	hnns
煳	hohu
燴	hohv
穭	holv
穭	holv
㬎	hoxm
炀	hpyh
秭	hpzi
黪	hpcj
䅟	hpcj
黲	hpcj
	hpcj
穇	hpcj
戾	hqli
欻	hqxu
欻	hqix
煲	hrbc
烂	hslj
炫	hsxr
烩	hshv
罴	hspi
縈	hsyk
灶	htzc
熘	htlq
烨	huye
焊	huhj
秆	hugj
炻	huui
焯	huvo
焯	huic
戽	huhu
焠	hucv
燾	hutc
燾	hudc
炖	hvdy
炝	hvql
炷	hwvu
黢	hwqu
炆	hwwf
焌	hwqu
焌	hwjy
稳	hxwf
虑	hxlv
焖	hxmf
燜	hxmf
繐	hxsv
煅	hydr
烊	hyyh
熳	hymj
扆	hyyi
煆	hyxx
煺	hztv
稃	hzfu
顾	iagu
辈	iabw
轿	iajn
轴	iavz
靥	iaye
辇	ianm
蚱	iava
蛐	iaqu
蚺	iarj
辚	ialb
厣	iayj
蚧	iajp
蛴	iaqi
虯	iaqq
蟈	iago
蟏	iaxn
蟬	iaij
蠐	iaqi
蠨	iaxn
軤	iahu
轔	ialb
轷	iahu
厴	iayj
砵	iabo
赝	ibyj
蟥	ibhl
蜞	ibqi
轵	ibvi
贗	ibyj
軹	ibvi
蠛	icmp
转	idvr
压	idya
厅	idtk
输	iduu
辆	idll
辅	idfu
蚁	idyi
厕	idsi
厕	idce
虾	idxx
轼	idui
螭	idii
蜗	idwo
龋	idqu
辏	idcz
轫	idrf
螨	idmj
轹	idli
蝲	idla
蟣	idji
軔	idrf
軚	idtd
厲	idli
辑	ieji
蜕	ietv
蛲	ienc
较	ifjn
蛰	ifve
螃	ifph
蜇	ifve
蚄	iffh
蚄	ifbh
轻	igqk
载	igzd
魇	igyj
虼	igge
齕	ighe
龁	ighe
螓	ihqb
厍	iiue
蠋	iivu
厙	iiue
斩	ijvj
轨	ijgv
蚬	ijxm
蛳	ijsi
虮	ijji
䗖	ijdi
䗛	ijxq
䜣	ijyb
䜣	ijxi
䜣	ijxb
螄	ijsi
螮	ijdi
訢	ijyb
訢	ijxi
訢	ijxb
辖	ikxx
轲	ikke
蜮	ikyu
辂	iklu
轱	ikgu
龉	ikyu
蟮	ikuj
蚵	ikee
龆	iktn
轺	ikyc
螗	ikth
蝘	ikyj
軲	ikgu
軺	ikyc
历	illi
辘	illu
蚴	ilyz
蜐	iljp
蚂	imma
蝾	imrs
蜢	immg
蚝	imhc
螞	imma
螠	imyi
辗	invj
辗	innm
辗	inzj
蝼	inlz
轶	inyi
蚨	infu
龈	inyb
龈	inkf
蛑	inmz
蛱	injx
蠓	inmg
蠊	inlm
蟓	inxl
蜾	ingo
蛺	injx
蠔	inhc
蠔	inhc
厢	ioxl
蜡	iola
厝	ioco
蝽	ioiy
螬	iocc
蜎	ioyr
蜰	ioxp
曆	ioli
礵	ioul
厉	ipli
轸	ipvf
蚜	ipya
蟛	ippg
软	iqrr
厌	iqyj
龃	iqju
蛃	irbk
蟎	irmj
龄	islk
蝥	ismc
辎	itzi
辐	itfu
龌	itwo
轾	itvi
蝰	itkv
蛏	itig
轩	iuxr
蟑	iuvh
蜓	iutk
轳	iulu
餍	iuyj
蝻	iunj
蜱	iupi
虷	iuhj
蚲	iupk
蟫	iuyb
蟫	iuxy
饜	iuyj
轮	ivly
蝇	ivyk
虬	ivqq
辄	ivve
轧	ivya
轧	ivva
轧	ivga
龇	ivzi
龅	ivbc
蚍	ivpi
辊	ivgy
蜣	ivql
轭	ivee
龀	ivif
辋	ivwh
蚆	ivba
蠟	ivla
輞	ivwh
輥	ivgy
齙	ivbc
齜	ivzi
歷	ivli
辙	iwve
蝈	iwgo
蛀	iwvu
輇	iwqr
辁	iwqr
螈	ixyr
螅	ixxi
蟪	ixhv
螵	ixpn
轰	iyhs
辕	iyyr
辍	iyio
蠼	iyqu
蝤	iyqq
蛘	iyyh
螋	iysz
龊	izio
䗴	iztk
虸	izzi
餸	izss
钟	javs
鉴	jajm
尬	jaga
览	jalj
锤	jaiv
铮	javg
钮	janq
钵	jabo
铎	jado
锺	javs
颀	jaqi
钏	jair
钜	jaju
铀	jayz
镛	jays
钨	jawu
帏	jaww
钾	jajx
觯	javi
锂	jali
钽	jatj
锸	jaia
钌	jaln
镉	jage
镩	jacr
觶	javi
釕	jaln
鈡	javs
鈾	jayz
鉀	jajx
鉭	jatj
鋰	jali
鍤	jaia
鎅	jagd
鎘	jage
鏞	jays
鏵	jahx
鏽	jaxq
頎	jaqi
镇	jbvf
锁	jbso
帕	jbpa
帜	jbvi
镔	jbbb
帧	jbvf
锴	jbkd
铂	jbbo
钡	jbbw
帻	jbze
镄	jbfw
鉑	jbbo
鋇	jbbw
鍇	jbkd
鐨	jbfw
鑌	jbbb
幘	jbze
铸	jcvu
锵	jcql
钳	jcqm
锝	jcde
锛	jcbf
锊	jclt
帱	jciz
帱	jcdc
帱	jccz
锎	jckd
鋝	jclt
錛	jcbf
鍀	jcde
鐦	jckd
帡	jcpk
幬	jciz
幬	jcdc
幬	jccz
铺	jdpu
钉	jddk
锅	jdgo
钧	jdjy
钓	jddn
锣	jdlo
钗	jdid
钛	jdtd
钹	jdbo
钺	jdyt
钠	jdna
铄	jduo
锲	jdqp
鎏	jdlq
镫	jddg
铡	jdva
镁	jdmw
铉	jdxr
鋈	jdwu
镆	jdmo
钚	jdbu
铟	jdyb
镧	jdlj
钒	jdfj
尥	jdln
钋	jdpo
锇	jdee
铫	jdyc
铫	jdtn
铫	jddn
䥽	jdpo
釙	jdpo
釩	jdfj
鈈	jdbu
鈉	jdna
鈦	jdtd
鈸	jdbo
銦	jdyb
鋂	jdmw
鋨	jdee
鍘	jdva
鍥	jdqp
鎂	jdmw
鏌	jdmo
鑭	jdlj
镜	jejk
锐	jerv
铛	jeig
铛	jedh
铳	jeis
铣	jexm
铣	jexi
觥	jegs
铆	jemc
铙	jenc
铒	jeer
铘	jeye
鉺	jeer
銳	jerv
鋣	jeye
鎲	jeth
镋	jeth
帨	jeuv
帮	jfbh
锋	jffg
锥	jfvv
镑	jfbh
鏊	jfao
铰	jfjn
钫	jffh
鈁	jffh
鉸	jfjn
鎊	jfbh
鏟	jfij
鏟	jfij
钱	jgqm
铐	jgkc
锷	jgee
钙	jggd
銎	jgqs
钇	jgyi
釔	jgyi
鈣	jggd
銬	jgkc
锹	jhqn
镳	jhbn
钬	jhho
锬	jhtj
鈥	jhho
錟	jhtj
鎢	jhwu
鎣	jhyk
鑣	jhbn
钂	jhth
铲	jiij
镯	jivo
錾	jizj
镪	jiql
鏹	jiql
鐲	jivo
斶	jiiu
锦	jjjb
鑫	jjxb
钪	jjkh
钸	jjbu
铈	jjui
铞	jjdn
虓	jjxn
鈧	jjkh
鈰	jjui
鈽	jjbu
銱	jjdn
钻	jkzr
铜	jkts
铭	jkmk
铅	jkqm
锯	jkju
锢	jkgu
铝	jklv
镐	jkhc
镐	jkgc
镝	jkdi
钴	jkgu
铬	jkge
锕	jkaa
锆	jkgc
锘	jkno
铪	jkke
铪	jkha
锔	jkju
铷	jkru
钶	jkke
钷	jkpo
锫	jkpw
鈳	jkke
鉆	jkzr
鉕	jkpo
鉻	jkge
鉿	jkke
鉿	jkha
銣	jkru
鋁	jklv
鋦	jkju
鋯	jkgc
錇	jkpw
錒	jkaa
鍩	jkno
铦	jkxm
铦	jktm
铦	jkgx
镕	jkrs
锄	jliu
铹	jllc
鐒	jllc
杂	jmza
朵	jmdo
尴	jmgj
铩	jmua
铢	jmvu
锰	jmmg
镍	jmnp
镒	jmyi
钔	jmmf
錳	jmmg
鍆	jmmf
鎳	jmnp
铁	jntp
银	jnyb
帐	jnvh
镰	jnlm
镂	jnlz
锒	jnlh
锞	jnke
铗	jnjx
幞	jnfu
觫	jnsu
铵	jnan
觖	jnjt
钕	jnnv
镓	jnjx
镤	jnpu
铼	jnld
襆	jnfu
釹	jnnv
銨	jnan
鋃	jnlh
錁	jnke
錸	jnld
鍊	jnlm
鎵	jnjx
鏷	jnpu
鐮	jnlm
幪	jnmg
错	joco
销	joxn
钥	joyt
钥	joyc
锏	jojm
旮	joga
锗	jove
钼	jomu
镅	jomw
锖	joql
镨	jopu
铕	joyz
镥	jolu
䦃	jovo
鈅	joyt
鈅	joyc
鉬	jomu
銪	joyz
錩	joih
鍺	jove
鎇	jomw
鐗	jojm
鐠	jopu
鐧	jojm
鐯	jovo
鑥	jolu
锠	joih
锡	jpxi
钞	jpic
锈	jpxq
镌	jpjr
觞	jpuh
帔	jppw
锑	jpti
铋	jpbi
铴	jpth
铍	jppi
钐	jpuj
䥺	jpya
釤	jpuj
釾	jpya
鈹	jppi
鉍	jpbi
銻	jpti
鍚	jpxi
鐋	jpth
钖	jpyh
	jpya
钦	jqqb
锨	jqxm
镢	jqjt
鍁	jqxm
鐝	jqjt
锭	jrdk
镟	jrxr
鏇	jrxr
铃	jslk
钩	jsgz
镙	jslo
鍪	jsmz
铥	jsdq
銩	jsdq
鍅	jsfh
鏍	jslo
孿	jslr
铿	jtkg
镭	jtlw
锚	jtmc
锉	jtco
镏	jtlq
镗	jtth
钿	jttm
钿	jtdm
锱	jtzi
钍	jttu
釷	jttu
銼	jtco
鎦	jtlq
鏜	jtth
鐳	jtlw
针	juvf
镞	juzu
钎	juqm
锌	juxb
幛	juvh
铧	juhx
钭	judz
镡	juxb
镡	jutj
镡	juij
鐾	jubw
镎	juna
釺	juqm
鈄	judz
鋅	juxb
鎿	juna
鑹	jucr
钝	jvdy
铠	jvkd
锟	jvky
铖	jvig
钯	jvba
锍	jvlq
钲	jvvg
钤	jvqm
铊	jvto
铊	jvta
铯	jvse
锩	jvjr
铌	jvni
钆	jvga
釓	jvga
鈀	jvba
鈐	jvqm
鈮	jvni
鉳	jvpw
銠	jvlc
銫	jvse
鋮	jvig
鋶	jvlq
錈	jvjr
錕	jvky
铑	jvlc
铓	jvmh
钰	jwyu
帼	jwgo
铨	jwqr
锃	jwzg
镦	jwdv
鈺	jwyu
鋥	jwzg
鑀	jwai
锽	jwhl
风	jxfg
钢	jxgh
镖	jxbn
镣	jxln
镲	jxia
锶	jxsi
锪	jxho
镱	jxyi
鋱	jxte
錼	jxna
鍃	jxho
鍶	jxsi
鏚	jxqi
鏢	jxbn
鐿	jxyi
鑔	jxia
铽	jxte
幖	jxbn
凤	jyfg
锻	jydr
镶	jyxl
镀	jydu
镊	jynp
镬	jyho
钣	jybj
铱	jyyi
锾	jyhr
锼	jysz
镘	jymj
锿	jyai
锓	jyqb
銥	jyyi
鋟	jyqb
錶	jybn
鍰	jyhr
鎄	jyai
鎩	jyua
鎪	jysz
鏺	jypo
鑊	jyho
鑲	jyxl
镮	jyhr
键	jzjm
链	jzlm
铤	jztk
铤	jzdk
鋌	jztk
鋌	jzdk
围	kaww
哼	kahg
啸	kaxn
哑	kaya
呜	kawu
啡	kafw
呸	kapw
喳	kava
喳	kaia
颐	kayi
嚅	karu
颚	kaee
嗝	kage
咝	kasi
吖	kaya
吖	kaaa
喱	kali
唪	kafg
吲	kayb
哜	kaji
咁	kagj
咈	kafu
咺	kaxr
哣	kadz
哣	kapz
啞	kaya
啴	kato
啴	katj
啴	kaij
嗶	kabi
嘓	kago
嘢	kaye
嘽	kato
嘽	katj
嘽	kaij
噇	kail
噓	kaxu
噓	kaui
嚌	kaji
圌	kaiv
圌	kair
圙	kalt
曱	kaga
甴	kaza
圆	kbyr
喷	kbpf
啪	kbpa
啧	kbze
呗	kbbw
呗	kbbd
匮	kbkv
匮	kbgv
喈	kbjp
唢	kbso
赜	kbze
賾	kbze
唝	kbhs
唝	kbgs
嗊	kbhs
嗊	kbgs
嗩	kbso
㗾	kbxt
匾	kcbm
哷	kclv
哷	kclp
喯	kcbf
嘚	kcde
噀	kcxy
圇	kcly
图	kdtu
吴	kdwu
吓	kdxx
吓	kdhe
卧	kdwo
咧	kdlp
呐	kdne
呐	kdna
哟	kdyo
噢	kdoo
喻	kdyu
咚	kdds
哧	kdii
哆	kddo
唰	kdux
嗨	kdhd
噔	kddg
咔	kdka
咛	kdnk
嗲	kddx
卟	kdbu
呔	kdtd
呔	kddd
呙	kdwo
呙	kdwd
呙	kdwa
呙	kdhe
呙	kdgx
呙	kdgo
凼	kddh
喁	kdys
啭	kdvr
哕	kdyt
哕	kdhv
吳	kdwu
呣	kdom
呣	kdmz
呣	kdvm
咑	kdda
唎	kdli
啩	kdgx
啰	kdlo
啲	kddi
喲	kdyo
嗞	kdzi
嘜	kdma
嘜	kdmd
嘰	kdji
嚟	kdlw
嚟	kdli
彧	kdyu
哪	kena
园	keyr
嘟	kedu
唧	keji
咣	kegl
啷	kelh
哓	kexn
嘧	kemi
咡	keer
嘅	kege
嘵	kexn
啕	kftc
嚯	kfho
囉	kflo
圐	kfku
嘎	kgga
呓	kgyi
戢	kgji
咗	kgzo
戙	kgds
嘿	khhw
唬	khhu
咴	khhv
嗪	khqb
噍	khjn
嗻	khvu
嗻	khve
囌	khsu
囷	khqy
虽	kisv
𪠳	kiie
唓	kiie
叽	kjji
咂	kjza
匦	kjgv
哳	kjva
匭	kjgv
骯	kjah
啊	kkaa
响	kkxl
吕	kklv
嘻	kkxi
咕	kkgu
咖	kkka
咖	kkga
啥	kkua
嚣	kkxn
嘀	kkdi
嗒	kkta
嗒	kkda
喏	kkre
喏	kkno
嗬	kkhe
叵	kkpo
咭	kkka
咭	kkji
唁	kkyj
啮	kknp
啁	kkvz
啁	kkvc
啁	kktn
匼	kkqx
匼	kkke
吅	kkss
吅	kkxr
咍	kkhd
哃	kkts
啹	kkko
喎	kkwd
喎	kkwo
嗆	kkql
嗐	kkhd
嗰	kkge
嚚	kkyb
囧	kkjs
另	kllk
啦	klla
勋	klxy
咙	klls
唠	kllc
呦	klyz
呖	klli
嘞	kllw
嘞	klle
勖	klxu
叻	klle
劻	klkl
勛	klxy
嘮	kllc
嚨	klls
吗	kmma
嗓	kmsh
咪	kmmi
咻	kmxq
嗑	kmke
哚	kmdo
啉	kmlj
啉	kmlb
嗌	kmyi
嗌	kmai
啋	kmcd
嗎	kmma
㗎	kmjx
㗎	kmga
唤	knhr
喂	knww
咦	knyi
噗	knpu
嚎	knhc
喽	knlz
哝	knns
嘤	knyk
囡	knnj
噱	knxt
噱	knjt
哞	knmz
哏	knhf
哏	kngf
呋	knfu
哌	knpd
唼	knua
匽	knyj
咉	knyh
咹	knee
咹	knan
咹	knvj
嘍	knlz
噥	knns
囅	knij
	knwo
㖞	knwo
咱	kozj
噜	kolu
啃	kokf
嘈	kocc
唷	koyo
嘣	kobg
喑	koyb
圊	koqk
嗍	koso
唶	koco
啫	kove
啫	koui
噲	kokk
嚐	koih
嚕	kolu
团	kptr
吵	kpic
嘭	kppg
叼	kpdn
啵	kpbo
咿	kpyi
囫	kphu
唦	kpua
嘐	kpxn
噦	kpyt
噦	kphv
吒	kqva
噘	kqjt
唣	kqzc
贝	krbw
啶	krdk
唡	krll
啢	krll
嘥	krsd
嗦	ksso
吆	ksyc
呤	kslk
噙	ksqb
辔	kspw
哙	kskk
嗉	kssu
唥	kslh
噝	kssi
囜	ksnb
喔	ktwo
喔	ktoo
喵	ktmn
噻	ktsd
唑	ktzo
喹	ktkv
嘡	ktth
噃	ktbo
噹	ktdh
唉	kuai
哗	kuhx
啤	kupi
啐	kuqi
啐	kucv
嗥	kuhc
噼	kupi
哔	kubi
𠮶	kuge
呯	kupk
唞	kutc
唞	kudz
嗱	kuna
斝	kujx
见	kvjm
吧	kvba
呢	kvni
呢	kvne
呃	kvee
吨	kvdy
呛	kvql
呲	kvzi
呲	kvci
囤	kvty
囤	kvdy
噶	kvga
囵	kvly
吡	kvpi
吡	kvbi
鼍	kvto
黾	kvmm
黾	kvmg
黾	kvmb
呒	kvom
唵	kvan
嚙	kvnp
嚦	kvli
囸	kvri
鼉	kvto
瓯	kwou
哐	kwkl
唛	kwma
唛	kwmd
啯	kwgo
喤	kwhl
噉	kwdj
噯	kwai
㕵	kwwh
㘎	kwhj
㘚	kwhj
嗯	kxog
嗯	kxen
哎	kxai
冈	kxgh
呕	kxou
嚓	kxia
嘹	kxln
嘁	kxqi
唿	kxhu
嘌	kxpn
吣	kxqb
吔	kxye
咇	kxbi
哋	kxdi
噁	kxwu
噁	kxee
㕮	kxtn
㕮	kxfu
叹	kytj
嚷	kyrh
吱	kyvi
嗡	kywg
嗖	kysz
囔	kynh
嗫	kynp
嗳	kyai
咩	kymp
嘬	kyzo
匜	kyyi
唚	kyqb
嗮	kysd
噏	kyha
噏	kyxi
嚄	kyoo
嚄	kyho
哒	kzda
嗵	kzts
囝	kzjm
哱	kzpo
哱	kzbo
哱	kzba
噠	kzda
颜	layj
竖	lauu
耩	lajl
龚	lbgs
赣	lbgj
贛	lbgj
龔	lbgs
为	ldww
办	ldbj
耦	ldou
䶮	ldyj
龑	ldyj
竞	lejk
聋	lels
势	lfui
飒	lfsa
耪	lfph
麇	lhqy
麇	lhjy
麂	ljji
哿	lkge
耥	lkth
耠	lkho
耢	lllc
耮	lllc
辦	llbj
亲	lmqb
亲	lmqk
耧	lnlz
耬	lnlz
耤	lojp
耤	loji
产	lpij
耖	lpic
歆	lqxb
竑	lshs
砻	luls
耱	lumo
礱	luls
瓿	lwbu
勰	lxxp
袭	lyxi
耲	lyhk
耔	lzzi
查	maia
验	mayj
监	majm
检	majm
桥	maqn
柜	maju
柜	magv
骄	majn
阎	mayj
驯	maxy
栅	mava
栅	mauj
栅	mace
驿	mayi
阐	maij
闸	mava
盎	maah
榨	mava
盅	mavs
闩	maur
桠	maya
阈	mayu
闱	maww
榉	maju
楂	mava
楂	maia
柙	maxx
棰	maiv
楦	maxr
桕	majq
闈	maww
驊	mahx
杻	manq
杻	maiz
柈	mapj
柈	mabj
樁	mavl
櫫	mavu
櫸	maju
粦	malb
粪	mbff
骥	mbji
槟	mbbk
槟	mbbb
阗	mbtm
桢	mbvf
骐	mbqi
闐	mbtm
闠	mbgv
阓	mbgv
朳	mbba
楨	mbvf
槚	mbjx
橫	mbhg
檟	mbjx
櫝	mbdu
树	mcuu
骗	mcpm
驸	mcfu
橱	mciu
榭	mcxp
骈	mcpm
駙	mcfu
栟	mcbf
櫥	mciu
欂	mcbo
糰	mctr
术	mduu
类	mdlw
栋	mdds
桨	mdjl
阑	mdlj
驮	mdto
驮	mddo
榆	mdyu
骊	mdli
杈	mdia
柠	mdnk
椤	mdlo
阕	mdqt
栎	mdyt
栎	mdli
棼	mdff
椟	mddu
阏	mdee
柒	mdqi
楱	mdzz
枘	mdrv
闋	mdqt
馱	mdto
馱	mddo
杕	mddo
杕	mddi
栘	mdyi
栻	mdui
梂	mdqq
槳	mdjl
㮾	mdlh
㰀	mdli
闻	mewf
阅	meyt
骁	mexn
梆	mebh
栉	mevi
驺	mezz
杌	mewu
骘	mevi
阋	mexi
郴	meif
桡	merc
桡	menc
桄	megl
籼	mexm
閱	meyt
騭	mevi
騶	mezz
柷	mevu
柷	meiu
梡	mekr
梲	mevo
棁	mevo
槥	mehv
秈	mexm
枫	mffg
骜	mfao
榷	mfqt
骓	mfvv
驁	mfao
榣	mfyc
欏	mflo
栈	mgvj
盏	mgvj
阀	mgfa
骋	mgig
枵	mgxn
梣	mgif
棫	mgyu
棽	mguf
棽	mgif
槜	mgzv
糕	mhgc
驴	mhlv
棂	mhlk
梌	mhtu
梌	mhia
棪	mhyj
槱	mhyz
槱	mhic
檁	mhlb
盉	mhhe
骚	misc
蛊	migu
闽	mimb
糨	mijl
栌	milu
椠	miqm
閩	mimb
闹	mjnc
榄	mjlj
闶	mjkh
枧	mjjm
閌	mjkh
梘	mjjm
櫈	mjdg
櫬	mjif
问	mkwf
骑	mkqi
骂	mkma
阁	mkge
阔	mkko
骆	mklo
驹	mkju
毡	mkvj
闾	mklv
榈	mklv
樯	mkql
椐	mkju
栝	mkgx
栝	mktm
栝	mkko
骀	mktd
榀	mkpb
闆	mkbj
枱	mktd
枱	mksi
枱	mkci
柖	mkuc
棓	mkpz
棓	mkbw
棓	mkbh
椆	mkvz
椆	mkiz
椆	mkdn
楛	mkku
楛	mkhu
驾	mljx
枥	mlli
栊	mlls
柺	mlgk
櫳	mlls
欐	mlli
闲	mmxm
闯	mmil
阖	mmhe
槛	mmkj
槛	mmjm
杩	mmma
榇	mmif
阃	mmky
閫	mmky
骉	mmbn
榅	mmwf
榪	mmma
樑	mmll
橾	mmuu
橾	mmqn
极	mnji
驶	mnui
骤	mnvz
樱	mnyk
棵	mnke
娄	mnlz
桉	mnan
驽	mnnu
阆	mnlh
樨	mnxi
橼	mnyr
骒	mnke
枨	mnig
毪	mnmu
閬	mnlh
騍	mnke
栐	mnys
桹	mnlh
梾	mnld
棖	mnig
棶	mnld
椓	mnvo
楩	mnpm
檞	mnjp
间	mojm
楣	momw
椭	moto
橹	molu
阍	mohy
阊	moih
糌	mozj
槠	movu
氆	mopu
氇	molu
榍	moxp
閒	moxm
閶	moih
閽	mohy
馹	mori
驲	mori
栒	moxy
棤	moqt
榰	movi
櫧	movu
氌	molu
糈	moxu
杨	mpyh
闭	mpbi
桫	mpso
糁	mpuf
骖	mpcj
粝	mpli
糝	mpuf
阙	mqqt
糗	mqqq
阒	mqqu
橛	mqjt
驵	mqzh
橥	mqvu
駔	mqzh
杴	mqxm
闪	mruj
骇	mrhd
阂	mrhe
枞	mrzs
枞	mrcs
閡	mrhe
欞	mrlk
盦	mran
构	msgz
栏	mslj
骡	mslo
闳	mshs
骛	mswu
驷	mssi
闫	msyj
糍	msci
柃	mslk
閆	msyj
閎	mshs
騖	mswu
㭕	msqu
桩	mtvl
盐	mtyj
闺	mtgv
檑	mtlw
骝	mtlq
樘	mtth
柽	mtig
騮	mtlq
榃	mttj
檔	mtdh
檯	mttd
盔	mukv
桦	muhx
骅	muhx
枰	mupk
榫	musy
榘	muju
糇	muhz
槔	mugc
餱	muhz
杄	muqm
枓	mudz
椑	mubw
櫆	mukv
枪	mvql
盘	mvpj
驰	mvii
驼	mvto
桅	mvww
阉	mvyj
粼	mvlb
粑	mvba
栳	mvlc
阄	mvjq
栀	mvvi
樾	mvyt
桤	mvqi
枍	mvyi
棬	mvqr
棬	mvjr
椸	mvyi
檵	mvji
驻	mwvu
骏	mwjy
棱	mwlk
棱	mwlg
闵	mwmb
闰	mwry
阚	mwkj
阚	mwhj
闞	mwkj
闞	mwhj
杧	mwmh
桯	mwyk
桯	mwtk
檉	mwig
糉	mwzs
标	mxbn
闷	mxmf
驱	mxqu
驳	mxbo
骠	mxpn
骠	mxbn
氅	mxih
骢	mxcs
檫	mxia
柰	mxnd
檩	mxlb
粞	mxxi
閪	mxhw
驄	mxcs
梽	mxvi
楒	mxsi
橑	mxln
橞	mxhv
㭎	mxgh
样	myyh
权	myqr
驭	myyu
骧	myxl
骟	myuj
阌	mywf
耰	myyz
閿	mywf
騸	myuj
糙	mzcc
籽	mzzi
闼	mzta
毽	mzjm
楗	mzjm
骣	mzij
驏	mzij
桲	mzbo
梴	mzyj
梴	mzij
梿	mzlm
槤	mzlm
娇	najn
鸟	nann
鸟	nadn
姬	naji
娅	naya
妞	nanq
鸦	naya
姗	nauj
鸭	naya
婶	nasf
婵	naij
鹉	nawu
妤	nayu
鹂	nali
嬗	nauj
鸬	nalu
妯	navz
娌	nali
鸸	naer
鸫	nads
䴓	naui
姅	nabj
姍	nauj
姮	nahg
婭	naya
嫿	nahx
鳾	naui
鴯	naer
鸝	nali
㛚	nats
婴	nbyk
鹦	nbyk
嫔	nbpb
鹈	nbti
鹆	nbyu
犋	nbju
鵒	nbyu
㜺	nbzj
鹊	ncqt
姘	ncpb
鹳	ncgr
鹋	ncmn
犏	ncpm
鶓	ncmn
婷	ndtk
鹤	ndhe
娱	ndyu
犊	nddu
鸩	ndvf
嫫	ndmo
鹌	ndan
妫	ndgv
䴕	ndlp
妭	ndba
娛	ndyu
媄	ndmw
媆	ndrr
媆	ndnf
嬤	ndma
嬤	ndmo
鴷	ndlp
鵪	ndan
妇	nefu
岛	nedc
娆	nerc
妧	neyr
妧	newj
嬈	nerc
姣	nfxn
姣	nfjn
鸷	nfvi
䴖	nfjk
媱	nfyc
嬥	nftn
鶄	nfjk
㛃	nfjp
鹧	ngve
犟	ngjl
鹘	nghu
鹘	nggu
鸲	ngqu
娀	ngss
嫲	ngma
鴝	ngqu
鶊	nggg
鹒	nggg
媯	nhgv
嫵	nhwu
嬀	nhgv
嬿	nhyj
鶖	nhqq
鸕	nhlu
鹙	nhqq
媸	niii
鸠	njjq
凫	njfu
媂	njti
媂	njdi
鸣	nkmk
鹃	nkjr
鸥	nkou
犄	nkji
嫱	nkql
鹗	nkee
牯	nkgu
牿	nkgu
姞	nkji
姤	nkgz
姤	nkdu
婍	nkqi
婠	nkwj
婠	nkwa
婤	nkvz
婤	nkiz
婳	nkhx
婼	nkro
媧	nkwa
嬙	nkql
鴞	nkxn
鵰	nkdn
鷗	nkou
鸮	nkxn
妈	nmma
娴	nmxm
枭	nmxn
娓	nmww
牦	nmmc
媪	nmao
鹇	nmxm
鷳	nmxm
鷴	nmxm
鹄	nnhu
姝	nnuu
媖	nnyk
㛹	nnpm
婧	nojk
眚	noug
䴗	noju
鶪	noju
奶	npnd
姊	npzi
鹅	npee
鸳	npyr
鸨	npbc
娣	npdi
鸱	npii
鸹	npgx
鹎	npbw
䴘	npti
媭	npxu
嫪	nplc
嬃	npxu
鴰	npgx
鶹	nplq
鷈	npti
鷉	npti
鹠	nplq
鸢	nqyr
姹	nqia
鹚	nqci
鹣	nqjm
奼	nqia
鶼	nqjm
鶿	nqci
婕	nrjp
娲	nrwa
鸽	nrge
姒	nrsi
鹪	nrjn
牮	nrjm
妠	nrnj
妠	nrna
媞	nrti
鶬	nrch
鸧	nrch
鸰	nrlk
嬷	nsmo
鹜	nswu
鹬	nsyu
婺	nswu
嫘	nslw
䴉	nshr
妘	nsyy
姈	nslk
嬤	nsma
嬤	nsmo
孌	nslr
鷥	nssi
鹮	nshr
嬸	ntsf
妒	nudu
鸪	nugu
嫜	nuvh
鹩	nuln
鹁	nubo
䴙	nupi
婞	nuxk
婥	nuio
婻	nunj
嫭	nuhu
鵓	nubo
鶘	nuhu
鷿	nupi
鸊	nupi
她	nvta
妮	nvni
妩	nvwu
媲	nvpi
鹞	nvyc
鸵	nvto
妗	nvjb
鹛	nvmw
雞	nvji
姱	nvkx
姱	nvhu
姽	nvgv
婘	nvqr
婘	nvjr
婫	nvky
婫	nvhy
鶥	nvmw
牤	nvmh
鹫	nwjq
鹑	nwiy
䴔	nwjn
媓	nwhl
嬡	nwai
牺	nxxi
媳	nxxi
妪	nxyu
妳	nxni
嫄	nxyr
嫕	nxyi
嫽	nxln
牠	nxta
鸡	nyji
袅	nynn
婊	nybn
嫒	nyai
鹨	nylq
鹱	nyhu
裊	nynn
婌	nyuu
嫚	nymj
嬛	nyxr
嬛	nyqs
嬛	nyhr
嬝	nynn
鷚	nylq
鸌	nyhu
鹭	nzlu
犍	nzjm
犍	nzqm
脸	oalm
题	oati
显	oaxm
睁	oavg
肿	oavs
睑	oajm
腼	oamm
肾	oauf
脐	oaqi
膻	oauj
膻	oadj
韪	oaww
颢	oahc
肼	oajk
胂	oauf
瞵	oalb
膦	oalb
脰	oadz
腨	oaur
𣈶	oaxr
冔	oaxu
韙	oaww
顥	oahc
旴	oaxu
晅	oaxr
暅	oaxr
曈	oats
睜	oavg
瞓	oaff
瞓	oaxy
膑	obbb
臏	obbb
臜	obza
臢	obza
晪	obtm
时	ocui
脟	oclp
膞	ocvr
昪	ocbm
瞪	oddg
盯	oddk
胁	odxp
瞒	odmj
盼	odpj
腻	odni
瞩	odvu
睽	odkv
胭	odyj
昀	odyy
脶	odlo
暌	odkv
腧	oduu
肽	odtd
腠	odcz
胨	odds
胩	odka
晡	odbu
眵	odii
脲	odnn
脷	odli
䏝	odvr
昡	odxr
暵	odhj
朓	odtn
晓	oexn
脘	oewj
朊	oerr
脫	oeto
腳	oejn
旵	oeij
曏	oexl
胜	ofug
胶	ofjn
臃	ofys
睢	ofsv
昉	offh
旷	ogkl
胫	ogjk
腭	ogee
胍	oggx
戥	ogdg
肟	ogwo
曌	ogvc
瞧	ohqn
瞅	ohiz
炅	ohjs
炅	ohgv
曛	ohxy
昈	ohhu
晱	ohuj
暂	oizj
晕	oiyy
晖	oihv
膙	oijl
螣	oitg
昕	ojxb
肮	ojah
旯	ojla
䁪	ojvj
睒	ojuj
脑	oknc
晌	okuh
胳	okge
胳	okga
晷	okgv
晗	okhj
眙	okyi
眙	okii
朐	okqu
朐	okiy
腒	okju
腡	oklo
䐃	okjs
昫	okxu
暱	okni
暿	okxi
睏	okky
瞘	okkz
胧	olls
昱	olyu
膪	olvd
膪	olva
膪	olik
昽	olls
曨	olls
曬	olud
腾	omtg
眯	ommi
睬	omcd
臊	omsc
瞌	omke
腽	omwa
氍	omqu
脎	omsa
脒	ommi
睏	omky
鹏	onpg
眨	onva
肤	onfu
胀	onvh
睐	onld
脓	onns
胰	onyi
胺	onan
媵	onyk
臁	onlm
䁖	onlz
腖	onds
昳	onyi
昳	ondp
暕	onlj
暕	onjm
睞	onld
瞜	onlz
㫰	onlh
腊	ooxi
腊	oola
腈	oojk
腯	ootu
〇	oolk
肠	opih
肜	oprs
胗	opvf
眢	opyr
肶	opbi
䏲	opti
䏲	opdp
旸	opyh
昒	ophu
昣	opvf
肷	oqqm
腚	ordk
胲	orhd
昺	orbk
晐	orgd
暶	orxr
昙	ostj
脍	oskk
瞀	osmc
胠	osqu
昤	oslk
脏	otzh
膛	otth
瞄	otmn
眭	otsv
眭	otgv
塍	otig
脞	otco
晊	otvi
晔	ouye
腩	ounj
胪	oulu
盱	ouxu
旰	ougj
旰	ouhj
肸	ouxi
啱	ounj
啱	ouyj
啱	oung
旿	ouwu
晫	ouvo
暲	ouvh
睺	ouhz
晚	ovwj
盹	ovdy
腌	ovyj
腌	ovaa
肫	oviy
肫	ovvy
暍	ovhe
暱	ovni
眶	owkl
睃	owso
腘	owgo
晙	owjy
朘	owjr
㬚	owie
瞟	oxpn
晾	oxll
膘	oxbn
眍	oxkz
腙	oxzs
腍	oxrf
䏡	oxui
喺	oxxi
暧	oyai
臌	oygu
瞍	oysz
胈	oyba
胣	oyii
脤	oyuf
脿	oybn
䲢	oytg
鰧	oytg
昄	oybj
㬊	oyhr
脖	ozbo
脬	ozpc
瞇	ozmi
须	paxu
顺	pauy
释	paui
乌	pawu
乔	paqn
颇	papo
颖	payk
颍	payk
裣	palm
袆	pahv
褘	pahv
鱟	pahz
祎	payi
禕	payi
质	pbvi
舆	pbyu
祯	pbvf
夤	pbyb
衬	pcif
禱	pcdc
乐	pdyt
乐	pdle
补	pdbu
祸	pdho
乓	pdph
袄	pdao
囱	pdcs
衩	pdia
氐	pddi
牍	pddu
祆	pdxm
祧	pdtn
牖	pdyz
褕	pdyu
裆	pedh
岙	peao
嶴	peao
祊	pfbg
粵	pgyt
舄	phxi
齄	phva
禚	phvo
裤	piku
裈	piky
褲	piku
视	pjui
币	pjbi
觋	pjxi
鼽	pjqq
虒	pjsi
禘	pjdi
褡	pkda
祜	pkhu
袼	pkge
裯	pkiz
嚳	pkku
祫	pkxx
褴	pmlj
臬	pmnp
祃	pmma
禡	pmma
长	pnvh
长	pnih
袜	pnwa
褛	pnlv
裉	pnkf
褚	povu
褚	pove
褚	poiu
裥	pojm
褙	pobw
襇	pojm
襉	pojm
彤	ppts
乒	pppk
衹	pqvi
齇	pqva
襝	prlm
么	psme
么	psyc
么	psmo
丢	psdq
祛	psqu
袪	psqu
丟	psdq
褔	ptfu
垕	pthz
飧	pusy
襻	pupj
戶	puhu
甩	pvuk
乇	pvve
乇	pvto
璺	pwwf
裎	pwig
舔	pxtm
囟	pxxb
裇	pxsv
囪	pxcs
祂	pxta
毁	pyhv
裱	pybn
裰	pydo
袯	pybo
褟	pyta
襏	pybo
裢	pzlm
褳	pzlm
狰	qavg
氟	qafu
氚	qair
氘	qadc
氩	qaya
猹	qava
猹	qaia
氬	qaya
狉	qapi
猃	qaxm
猙	qavg
狈	qbbw
贰	qber
獭	qbta
獷	qbgl
关	qdgr
狞	qdnk
忒	qdte
忒	qdtv
猡	qdlo
氯	qdlv
猁	qdli
氡	qdds
㺄	qdyu
兰	qelj
獍	qejk
狁	qeyy
氪	qeke
氙	qexm
峱	qenc
飙	qfbn
獒	qfao
獾	qfhr
玀	qflo
犷	qggl
氢	qgqk
氫	qgqk
氮	qhdj
狳	qhyu
獯	qhxy
蠲	qijr
狮	qjui
犰	qjqq
犺	qjkh
猞	qkue
狺	qkyb
㹢	qkjx
犸	qmma
氲	qmyy
猱	qmnc
猓	qmgo
氳	qmyy
獁	qmma
獬	qnxp
氨	qnan
獴	qnmg
㹴	qngh
猎	qolp
猬	qoww
猢	qohu
氰	qoqk
猸	qomw
氖	qpnd
氕	qppp
狱	qqyu
氦	qrhd
獫	qrxm
县	qsxm
兹	qszi
兹	qsci
狯	qskk
綦	qsqi
猻	qssy
狴	qtbi
獐	quvh
犴	quhj
犴	quan
狨	qurs
狍	qvpc
夔	qwkv
狻	qwsr
獠	qxln
猕	qxmi
狲	qxsy
惎	qxji
狝	qxxm
獮	qxxm
獼	qxmi
氧	qyyh
领	ralk
伟	raww
倾	raqk
佣	rays
颔	rahj
侨	raqn
伫	ravu
俭	rajm
颌	rahe
颌	rage
佥	raqm
侪	raid
伾	rapi
倕	raiv
偁	raig
偁	raif
偭	ramm
僜	radg
僰	rabo
頜	rahe
頜	rage
俱	rbju
债	rbvd
侦	rbvf
偾	rbff
傧	rbbb
僨	rbff
儐	rbbb
俦	rciz
倴	rcbf
傉	rcnu
僎	rcvr
僔	rczy
弇	rcyj
传	rdvr
传	rdir
每	rdmw
份	rdff
优	rdyz
偷	rdtz
侧	rdvd
侧	rdce
侧	rdzd
彻	rdie
仪	rdyi
俩	rdll
俞	rdyu
伪	rdww
衔	rdxm
佟	rdts
俪	rdli
仃	rddk
俅	rdqq
傣	rddd
佧	rdka
氽	rdty
汆	rdcr
僦	rdjq
衎	rdkj
衕	rdts
衚	rdhu
衠	rdvy
伕	rdfu
伭	rdxr
伭	rdxm
侴	rdhc
俁	rdyu
偰	rdxp
傒	rdxi
儳	rdij
㑊	rdyi
㑩	rdlo
侥	reyc
侥	rejn
傥	reth
佴	rend
佴	reer
侁	reuf
倻	reye
㑇	revz
㑳	revz
仿	rffh
傩	rfno
傕	rfqt
傕	rfjt
僱	rfgu
儸	rflo
徬	rfph
亿	rgyi
戗	rgql
仝	rgts
侉	rgkx
俜	rgpk
仡	rgyi
仡	rgge
戧	rgql
伙	rhho
僬	rhjn
倓	rhtj
儦	rhbn
俨	riyj
觎	rjyu
仉	rjvh
伣	rjqm
佈	rjbu
俙	rjxi
倘	rkth
侣	rklv
偌	rkro
倜	rkti
倌	rkgr
侗	rkts
侗	rkds
徜	rkih
佁	rkyi
佁	rkii
佔	rkvj
佢	raqu
佸	rkho
侷	rkju
傖	rkif
傖	rkcf
徛	rkji
伤	rluh
龛	rlkj
们	rmmf
傈	rmli
僳	rmsu
毹	rmuu
籴	rmdi
偎	rnww
侬	rnns
偻	rnlv
偻	rnlz
伥	rnih
徕	rnld
侔	rnmz
胬	rnnu
倮	rnlo
鸺	rnxq
伋	rnji
俍	rnll
俠	rnxx
俫	rnld
倀	rnih
倈	rnld
傢	rnjx
傢	rnjx
鵂	rnxq
储	roiu
俏	roqn
佾	royi
偺	rozj
僩	roxm
儈	rokk
伢	rpya
隽	rpjy
隽	rpjr
佖	rpbi
僇	rplu
值	rqvi
佽	rqci
侂	rqto
众	rrvs
肏	rrcc
偿	rsih
仨	rssa
侩	rskk
仫	rsmu
俬	rssi
俬	rssi
侄	rtvi
畲	rtue
偓	rtwo
儅	rtdh
畬	rtyu
畬	rtue
伞	rusj
仵	ruwu
搿	ruge
罉	ruch
伦	rvly
仓	rvch
仑	rvly
佬	rvlc
伧	rvif
伧	rvcf
伲	rvni
仳	rvpi
偡	rvvj
复	rwfu
傻	rwua
徵	rwvi
徵	rwvg
儆	rwjk
佤	rwwa
瓴	rwlk
佺	rwqr
你	rxni
德	rxde
佘	rxue
伛	rxyu
傺	rxii
伈	rxxb
倞	rxll
倞	rxjk
倧	rxzs
傃	rxsu
傯	rxzs
悆	rxyu
悆	rxuu
仅	ryjb
翎	rylk
徉	ryyh
儋	rydj
儇	ryxr
偯	ryyi
儴	ryxl
儴	ryrh
侹	rztk
预	sayu
缠	saij
纠	sajq
纽	sanq
绯	safw
绅	sauf
绊	sabj
缰	sajl
纬	saww
缅	samm
绛	sajl
绎	sayi
纾	sauu
缬	saxp
缍	sado
绋	safu
紓	sauu
紼	safu
綞	sado
繡	saxq
繫	saxi
繫	saji
繮	sajl
纻	savu
织	sbvi
缩	sbso
绩	sbji
缤	sbbb
缜	sbvf
缵	sbzr
缋	sbhv
縝	sbvf
繢	sbhv
纊	sbkl
纘	sbzr
编	scbm
缚	scfu
纣	scvz
缛	scru
绀	scgj
罗	sdlo
终	sdvs
续	sdxu
约	sdyt
练	sdlm
纷	sdff
纳	sdna
绿	sdlv
绿	sdlu
罚	sdfa
纨	sdwj
纫	sdrf
绂	sdfu
餈	sdci
紈	sdwj
紉	sdrf
紱	sdfu
綠	sdlv
綠	sdlu
绗	sdhh
统	sets
绕	serc
绑	sebh
缉	seji
绉	sevz
綁	sebh
縐	sevz
维	sfww
绞	sfjn
纺	sffh
絷	sfvi
经	sgjk
红	sghs
线	sgxm
绔	sgku
纥	sghe
纥	sgge
纩	sgkl
缂	sgke
紇	sghe
紇	sgge
絝	sgku
緙	sgke
炱	shtd
蟊	simc
绵	sjmm
缔	sjdi
缆	sjlj
给	skgw
给	skji
结	skjp
绍	skuc
络	sklo
络	sklc
绮	skqi
绸	skiz
缄	skjm
绾	skwj
绺	sklq
缮	skuj
绌	skiu
缟	skgc
绐	skdd
绱	skuh
䌹	skjs
鞝	skuh
絀	skiu
綹	sklq
緔	skuh
羁	smji
绦	smtc
缢	smyi
毵	smsj
缲	smsc
缲	smqn
枲	smxi
毿	smsj
縕	smyy
縕	smwf
繅	smsc
缊	smyy
缊	smwf
级	snji
缘	snyr
缕	snlv
缨	snyk
绥	snsv
缫	snsc
缣	snjm
绠	sngg
缏	snbm
綆	sngg
緣	snyr
緶	snbm
縑	snjm
縴	snxm
縴	snqm
绪	soxu
绷	sobg
绢	sojr
绚	soxr
绡	soxn
缙	sojb
缃	soxl
缗	somb
缯	sozg
罾	sozg
綃	soxn
綳	sobg
緗	soxl
繒	sozg
纱	spua
绣	spxq
缪	spmz
缪	spmq
缪	spmn
缈	spmn
绨	spti
綈	spti
组	sqzu
纸	sqvi
歜	sqiu
纵	srzs
绽	srvj
缇	srti
眾	srvs
緹	srti
罢	sspi
罢	ssba
绘	sshv
叁	sssj
纭	ssyy
缡	ssli
缧	sslw
叄	sssj
縭	ssli
细	stxi
缁	stzi
絰	stdp
縶	stvi
绖	stdp
纤	suxm
纤	suqm
绰	suio
绰	suic
绒	surs
辫	subm
纡	suyu
缑	sugz
罱	sulj
睪	sugc
紝	surf
緱	sugz
纴	surf
绝	svjt
继	svji
纪	svji
纯	sviy
绳	svug
罡	svgh
纶	svly
纶	svgr
纰	svpi
纰	svbi
绻	svqr
绲	svgy
绁	svxp
絕	svjt
緄	svgy
纹	swwf
缴	swvo
缴	swjn
绫	swlk
繳	swvo
繳	swjn
综	sxzs
纲	sxgh
缭	sxln
缥	sxpn
缌	sxsi
緦	sxsi
缓	syhr
缎	sydr
缀	syvv
绶	syuz
缳	syhr
缦	symj
繯	syhr
缝	szfg
缱	szqm
缒	szvv
繾	szqm
坚	tajm
圳	tavf
坞	tawu
坯	tapi
垩	taee
墉	tays
垭	taya
疃	tatr
畀	tabi
墼	taji
塥	tage
垏	talv
垿	taxu
埇	tays
埡	taya
埵	tado
墐	tajb
坝	tbba
埙	tbxy
坌	tbbf
塤	tbxy
埘	tcui
塮	tcxp
弆	tcju
埚	tdgo
坻	tdii
坻	tddi
坶	tdmu
坼	tdie
圢	tdtk
坋	tdff
坋	tdbf
堧	tdrr
塏	tdkd
塱	tdlh
坠	tevv
垸	teyr
垸	tehr
垱	tedh
垫	tfdm
塄	tflg
堃	tfky
塝	tfbh
垮	tgkx
圹	tgkl
圬	tgwu
圪	tgge
坬	tggx
垙	tggl
埪	tgks
塆	tgwj
墘	tgqm
壪	tgwj
墕	thyj
壎	thxy
堑	tiqm
埽	tjsc
幫	tjbh
墙	tkql
坷	tkke
墒	tkuh
坫	tkdm
垧	tkuh
垌	tkts
垌	tkds
垴	tknc
耇	tkgz
坰	tkjs
垎	tkhe
埫	tkuh
埫	tkis
堌	tkgu
墑	tkdi
垃	tlla
垄	tlls
坳	tlao
垅	tlls
坜	tlli
墈	tlkj
墡	tluj
壠	tlls
垛	tmdo
堞	tmdp
墚	tmll
塭	tmwf
壚	tmlu
块	tnkk
圾	tnji
埂	tngg
墀	tnii
埭	tndd
垵	tnan
埌	tnlh
墣	tnpu
㙘	tnyc
㚻	tnji
增	tozg
垍	toji
堉	toyu
堾	toir
壩	toba
场	tpih
埸	tpyi
埗	tpbu
畎	tqqr
圫	tqyu
圫	tqvy
坥	tqqu
垞	tqia
垡	trfa
埞	trdi
堨	trye
堨	tree
堨	trai
堨	trvd
㙦	trxp
坛	tstj
垒	tslw
坽	tslk
垚	ttyc
堐	ttya
堼	ttfg
墦	ttfj
壋	ttdh
圩	tuxu
圩	tuww
堠	tuhz
垆	tulu
埤	tupi
圲	tuqm
垾	tuhj
墊	tudm
毗	tvpi
垦	tvkf
坨	tvto
畹	tvwj
坭	tvni
圯	tvyi
圮	tvpi
垲	tvkd
埏	tvyj
埏	tvuj
埯	tvan
堍	tvtu
坉	tvty
坉	tvdy
堲	tvji
塃	tvhl
塈	tvji
壢	tvli
坟	twff
墩	twdy
坍	twtj
埕	twig
堎	twlg
尘	txif
塬	txyr
埝	txnm
堖	txnc
塽	txul
圣	tyug
塌	tyta
翥	tyvu
畈	tyfj
墁	tymj
垟	tyyh
塅	tydr
㙍	tydo
垯	tzda
垺	tzpz
垺	tzfu
墶	tzda
毕	uabi
韩	uahj
碰	uapg
颠	uadm
壶	uahu
硕	uauo
矫	uajn
磷	ualb
馅	uaxm
颉	uaxp
颉	uajx
颉	uajp
碴	uaia
馐	uaxq
馑	uajb
砷	uauf
碹	uaxr
砩	uafw
砩	uafu
硷	uajm
砟	uava
榘	uaju
礓	uajl
馇	uaia
壸	uaky
餷	uaia
饈	uaxq
屝	uafw
硚	uaqn
磾	uadi
礆	uajm
馈	ubkv
磺	ubhl
碘	ubdm
馔	ubvr
碛	ubqi
屄	ubbi
㞎	ubba
擎	ucqk
饼	ucbk
礴	ucbo
碥	ucbm
龙	udls
卖	udmd
协	udxp
饿	udee
砖	udvr
馋	udij
砾	udli
挲	udua
泵	udbg
馍	udmo
矽	udxi
矾	udfj
硎	udxk
饫	udyu
硪	udwo
碡	udvz
鼷	udxi
䃎	udva
飣	uddk
餈	udci
饃	udmo
饞	udij
饤	uddk
鼢	udff
碔	udwu
饶	uerc
饵	ueer
硗	ueqn
挚	ufvi
饺	ufjn
砜	uffg
碸	uffg
矿	ugkl
饯	ugjm
砼	ugts
矻	ugku
馀	uhyu
碳	uhtj
蚀	uiui
砗	uiie
螱	uiww
擊	uiji
硨	uiie
确	ujqt
饰	ujui
砸	ujza
壳	ujqn
壳	ujke
饥	ujji
砚	ujyj
矶	ujji
碲	ujdi
觌	ujdi
屌	ujdn
馆	ukgr
躺	ukth
础	ukiu
饲	uksi
饷	ukxl
啬	ukse
碉	ukdn
碱	ukjm
饴	ukyi
硌	uklo
硌	ukge
屙	ukee
鼯	ukwu
硐	ukds
軀	ukqu
冇	ukmc
喆	ukve
嚭	ukpi
囍	ukxi
餎	ukle
餎	ukge
饹	ukle
饹	ukge
砢	uklo
礄	ukqn
饬	ulii
砬	ulli
砬	ulla
攰	ullw
攰	ulgv
磡	ulkj
躲	umdo
码	umma
磕	umke
碟	umdp
麴	umqu
磲	umqu
磉	umsh
餼	umxi
尷	umgj
丧	unsh
馁	unnw
鼹	unyj
鹕	unhu
砭	unbm
硖	unxx
屦	unju
礞	unmg
餵	unww
屢	unlv
屨	unju
鼴	unyj
砆	unfu
硃	unvu
硤	unxx
餚	uoyc
碜	upif
砀	updh
饧	upxk
砑	upya
餳	upxk
毐	upai
碭	updh
磣	upif
砍	uqkj
饩	uqxi
华	urhx
饮	uryb
屣	urxi
层	uscg
砝	usfa
馏	utlq
矬	utco
礌	utlw
砰	uupg
饪	uurf
鼙	uupi
矸	uugj
䃅	uudi
飪	uurf
饱	uvbc
屉	uvti
砣	uvto
饨	uvty
馄	uvhy
硭	uvmh
砘	uvdy
餛	uvhy
屜	uvti
礅	uwdy
馓	uwsj
饊	uwsj
尪	uwwh
硒	uxxi
砹	uxai
硇	uxnc
礤	uxca
硵	uxlu
磠	uxlu
饭	uyfj
馒	uymj
馊	uysz
彀	uygz
嘏	uygu
毂	uygu
馕	uynh
觳	uyhu
磙	uygy
羼	uyij
餿	uysz
饢	uynh
榖	uygu
饽	uzbo
𩠌	uzss
餑	uzbo
餸	uzss
屘	uzmi
屘	uzmj
马	vama
肃	vasu
签	vaqm
频	vapb
颈	vajk
颈	vagg
箫	vaxn
筠	vajy
暨	vaji
舀	vayc
笮	vazo
笮	vaze
箅	vabi
舯	vavs
笪	vada
肀	vayi
舴	vaze
篚	vafw
箨	vato
彐	vaji
簞	vadj
籲	vayu
籲	vaxu
籁	vbld
篑	vbkv
箦	vbze
舥	vbpa
异	vcyi
导	vcdc
筹	vciz
发	vdfa
飞	vdfw
书	vduu
买	vdmd
录	vdlu
箩	vdlo
篾	vdmp
簦	vddg
舣	vdyi
舠	vddc
錄	vdlu
彔	vdlu
箓	vdlu
籙	vdlu
舢	veuj
篼	vedz
筇	veqs
岊	vejp
籮	vflo
笺	vgjm
戕	vgql
舡	vggh
戣	vgkv
虢	vhgo
篪	vhii
艅	vhyu
舻	vilu
黡	viyj
舰	vjjm
凳	vjdg
觅	vjmi
筛	vjud
笕	vjjm
簖	vjdr
籪	vjdr
齿	vkii
箬	vkro
篙	vkgc
笤	vktn
笸	vkpo
笱	vkgz
筘	vkkz
䝙	vkiu
貙	vkiu
劲	vljk
劲	vljb
笼	vlls
簏	vllu
笔	vmbi
篮	vmlj
笃	vmdu
艉	vmww
艋	vmmg
簋	vmgv
巢	vnic
筷	vnkk
篓	vnlz
鸶	vnsi
箧	vnqp
孓	vnjt
筻	vngh
简	vojm
箐	voqk
箐	vojk
艏	vouz
艄	vouc
筲	vouc
步	vpbu
乡	vpxl
笫	vpzi
歲	vpsv
簌	vqsu
篱	vsli
篡	vscr
繇	vsyz
繇	vsyc
舲	vslk
甾	vtzd
貓	vtmc
颦	vupb
飨	vuxl
竽	vuyu
筚	vubi
毌	vuwj
毌	vugr
籜	vuto
舱	vvch
邕	vvys
巯	vvqq
彘	vvvi
卺	vvjb
筢	vvpa
舭	vvbi
箢	vvyr
艴	vvfu
巹	vvjb
○	vvlk
艎	vwhl
舾	vxxi
筊	vxjn
爱	vyai
歧	vyqi
舨	vybj
叚	vyxx
叚	vyjx
笾	vzbm
籩	vzbm
齐	waqi
颤	wavj
颤	waij
斋	wavd
玮	waww
顼	waxu
齑	waji
颏	wake
颃	wahh
亸	wado
嚲	wado
頊	waxu
頦	wake
玙	wayu
玠	wajp
珅	wauf
琤	waig
瑄	waxr
瑋	waww
败	wbbd
琪	wbqi
琐	wbso
瓒	wbzj
璜	wbhl
珙	wbgs
敫	wbjn
兲	wbtm
璵	wbyu
瓚	wbzj
弈	wcyi
处	wdiu
离	wdli
环	wdhr
赢	wdyk
嬴	wdyk
玎	wddk
斓	wdlj
珩	wdhg
蠃	wdlo
玢	wdff
玢	wdbb
珧	wdyc
斕	wdlj
琍	wdli
琭	wdlu
璣	wdji
峦	welr
兖	weyj
琊	weya
兗	weyj
珰	wedh
璀	wfcv
雒	wflo
產	wfij
瓤	wgrh
琰	whyj
啟	whqi
珲	wihy
珲	wihv
现	wjxm
玑	wjji
銮	wjlr
帟	wjyi
琦	wkqi
噩	wkee
瑭	wkth
璐	wklu
玷	wkdm
琚	wkju
珺	wkjy
瑲	wkql
瑲	wkch
务	wlwu
珑	wlls
玛	wmma
琛	wmif
璨	wmcj
栾	wmlr
敉	wmmi
杗	wmmh
鸾	wnlr
璎	wnyk
娈	wnlr
璩	wnqu
玦	wnjt
昝	wozj
玥	woyt
珣	woxy
璿	woxr
敌	wpdi
彥	wpyj
斆	wpxt
斆	wpxn
琇	wpxq
珉	wqmb
亹	wqww
亹	wqmf
璇	wrxr
敛	wrlm
脔	wrlr
珐	wsfa
备	wtbw
亩	wtmu
璠	wtfj
璫	wtdh
挛	wulr
甏	wubg
饔	wuys
玕	wugj
琬	wvwj
琨	wvky
玘	wvqi
玱	wvql
玱	wvch
㻬	wvtu
玫	wwmw
珏	wwjt
玟	wwwf
玟	wwmb
敔	wwyu
璈	wwao
璦	wwai
琼	wxqs
琮	wxcs
璁	wxcs
忞	wxwf
忞	wxmb
璟	wxjk
变	wybm
亵	wyxp
衮	wygy
瑗	wyyr
瑷	wyai
裒	wypz
裛	wyyi
珢	wyyb
珢	wykf
孪	wzlr
琏	wzlm
璉	wzlm
举	xaju
恶	xaee
恶	xawu
懂	xads
衅	xaxb
惮	xadj
惮	xada
忡	xais
忑	xate
忐	xatj
悱	xafw
悝	xali
悝	xakv
怍	xava
怿	xayi
鲎	xahz
恧	xanv
衃	xapw
愐	xamm
慆	xatc
慬	xaqb
慬	xajb
憕	xavg
憕	xaig
憕	xadg
懟	xadv
总	xbzs
兴	xbxk
愤	xbff
惯	xbgr
懒	xblj
愦	xbkv
黉	xbhs
憒	xbkv
窸	xbxi
义	xdyi
怀	xdhk
态	xdtd
忧	xdyz
恻	xdce
怵	xdiu
懑	xdmf
泶	xdxt
忉	xddc
忭	xdbm
衊	xdmp
乸	xdna
弒	xdui
愷	xdkd
崽	xezd
卹	xexu
峃	xext
悅	xeyt
㤘	xevz
㥮	xevz
飘	xfpn
愣	xflg
恝	xfjx
恔	xfxn
恔	xfjn
忆	xgyi
悈	xgke
悈	xgjp
惔	xhtj
惔	xhdj
恽	xiyy
惲	xiyy
觉	xjjt
觉	xjjn
惭	xjcj
恼	xknc
惦	xkdm
喾	xkku
惝	xkth
惝	xkih
怊	xkic
怗	xktp
慪	xkou
慪	xkou
恸	xlts
戆	xlvl
戆	xlgh
戇	xlvl
戇	xlgh
杀	xmua
愠	xmyy
怅	xnih
惬	xnqp
尐	xndi
悢	xnll
愜	xnqp
懞	xnmg
懵	xomg
惛	xomf
惛	xohy
愔	xoyb
愭	xoqi
惕	xpti
慼	xpqi
悬	xqxr
忾	xqxi
忾	xqkd
恹	xqyj
忺	xqxm
懨	xqyj
歅	xqyj
歅	xqyb
您	xrnb
惩	xrig
怂	xrss
憷	xriu
尝	xsih
恿	xsys
愫	xssu
忪	xsvs
忪	xsss
悭	xtqm
悻	xuxk
忏	xuij
悫	xuqt
怔	xvvg
恳	xvkf
恺	xvkd
憨	xvhj
惋	xvwj
怆	xvil
怃	xvwu
忳	xvvy
忳	xvty
忳	xvdy
愒	xvkd
惫	xwbw
悯	xwmb
憝	xwdv
敩	xwxt
敩	xwxn
㥄	xwlk
惊	xxjk
憋	xxbp
懔	xxlb
怄	xxou
尜	xxga
卐	xxwj
恓	xxxi
恓	xxqi
悰	xxcs
惗	xxnp
憭	xxln
懞	xxmg
慑	xyue
怼	xydv
忮	xyvi
惙	xyiv
惙	xyio
让	yarh
讲	yajl
养	yayh
训	yaxy
谨	yajb
译	yayi
诈	yava
讳	yahv
诵	yass
谑	yaxt
霁	yaji
谄	yaij
诽	yafw
诤	yavg
颡	yash
讵	yaju
颥	yaru
詎	yaju
谉	yauf
顙	yash
顬	yaru
翀	yais
识	ybui
识	ybvi
谐	ybxp
对	ycdv
谢	ycxp
讨	yctc
诗	ycui
羿	ycyi
谝	ycpm
酹	yclw
譸	ycuz
诪	ycuz
议	ydyi
诉	ydsu
试	ydui
误	ydwu
读	yddz
读	yddu
订	yddk
霉	ydmw
谕	ydyu
诫	ydjp
酱	ydjl
讷	ydne
诲	ydhv
诋	yddi
谗	ydij
谟	ydmo
酶	ydmw
谰	ydlj
讣	ydfu
酾	ydui
酾	ydud
酚	ydff
酞	ydtd
谫	ydjm
讕	ydlj
醬	ydjl
说	yeuo
说	yeyt
说	yeuv
讪	yeuj
诌	yevz
诜	yeuf
酰	yexm
谠	yedh
訕	yeuj
詵	yeuf
說	yeuo
說	yeyt
說	yeuv
謅	yevz
难	yfnj
谁	yfuw
谁	yfuv
访	yffh
讽	yffg
谣	yfyc
翟	yfvd
翟	yfdi
翟	yfzd
谤	yfbh
雠	yfiz
戏	ygxi
讧	yghs
讫	ygqi
谔	ygee
谶	ygif
雩	ygyu
羟	ygql
羥	ygql
谈	yhtj
诙	yhhv
谯	yhqn
醮	yhjn
酴	yhtu
羰	yhth
譙	yhqn
讜	yhdh
诨	yihy
酽	yiyj
翚	yihv
翬	yihv
观	yjgr
讥	yjji
谛	yjdi
话	ykhx
语	ykyu
调	yktn
调	ykdn
诺	ykno
词	ykci
诏	ykvc
诃	ykhe
谪	ykve
谲	ykjt
诘	ykjp
诘	ykji
诰	ykgc
诟	ykgz
酮	ykts
谘	ykzi
诂	ykgu
诒	ykyi
诒	ykdd
醅	ykpw
诎	ykqu
醣	ykth
酤	ykgu
詘	ykqu
雾	ylwu
劝	ylqr
雳	ylli
釃	ylui
釃	ylud
谋	ymmz
谍	ymdp
谧	ymmi
谥	ymui
醞	ymyy
霂	ymmu
课	ynke
艰	ynjm
谦	ynqm
诀	ynjt
诛	ynvu
酿	ynnl
谏	ynjm
谀	ynyu
诿	ynww
诼	ynvo
诔	ynlw
醭	ynbu
諉	ynww
諑	ynvo
请	yoqk
诸	yovu
谓	yoww
询	yoxy
谱	yopu
诣	yoyi
谙	yoan
诮	yoqn
醑	yoxu
谮	yozf
酯	yovi
諝	yoxu
谞	yoxu
䲠	yoiy
讶	ypya
诱	ypyz
诊	ypvf
谬	ypmq
谚	ypyj
欢	yqhr
诧	yqia
叠	yqdp
谊	yqyi
诅	yqzu
谳	yqyj
讞	yqyj
该	yrgd
认	yrrf
羡	yrxm
诬	yrwu
酝	ysyy
讼	ysss
诖	ytgx
詿	ytgx
讅	ytuf
许	yuxu
计	yuji
讯	yuxy
评	yupk
辩	yubm
谭	yutj
诶	yuei
讦	yujp
谇	yusv
酐	yugj
誒	yuei
誶	yusv
记	yvji
论	yvly
证	yvvg
诚	yvig
诡	yvgv
谎	yvhl
诞	yvdj
霭	yvai
谒	yvye
讹	yvee
酡	yvto
谌	yvuf
谌	yvif
訾	yvzi
醌	yvky
襬	yvbd
諶	yvuf
諶	yvif
謊	yvhl
讬	yvto
酏	yvyi
醃	yvyj
醃	yvaa
羓	yvba
雯	ywwf
诠	ywqr
诳	ywkl
谡	ywsu
诓	ywkl
醛	ywqr
羧	ywso
誆	ywkl
釅	ywyj
谅	yxll
酗	yxxu
讴	yxou
谂	yxuf
諗	yxuf
设	yyue
详	yyxl
诩	yyxu
谩	yymj
谵	yyvj
诹	yyzz
谖	yyxr
詡	yyxu
諼	yyxr
譭	yyhv
譾	yyjm
叕	yyyi
叕	yyvo
叕	yyli
叕	yyjt
敠	yyvv
谜	yzmi
谴	yzqm
谆	yzvy
醚	yzmi
还	zahd
还	zahr
进	zajb
遗	zayi
违	zaww
迈	zamd
踹	zaik
蹿	zacr
跻	zaji
逦	zali
迓	zaya
邅	zavj
邐	zali
递	zbdi
趴	zbpa
踬	zbvi
趱	zbzj
躜	zbzr
逭	zbhr
趲	zbzj
躦	zbzr
过	zcgo
踌	zciz
蹰	zciu
跗	zcfu
蹁	zcpm
趼	zcjm
躕	zciu
达	zdda
跃	zdyt
蹬	zddg
蹒	zdpj
趔	zdlp
踽	zdju
趵	zdbc
跞	zdlo
跞	zdli
蜅	zdpu
远	zeyr
运	zeyy
趋	zequ
跷	zeqn
踯	zevi
遄	zeir
蹺	zeqn
跤	zfjn
躏	zflb
踅	zfxt
连	zilm
躝	zjlj
趟	zkth
跆	zktd
踮	zkdm
踣	zkbo
䢛	zkjs
踎	zkbw
踦	zkqi
边	zlbm
勐	zlmg
踩	zmcd
跺	zmdo
遴	zmlb
蹀	zmdp
躒	zmlo
躒	zmli
选	znxr
趿	znta
躝	znlj
𨅬	znlj
蹦	zobg
蹭	zocg
遢	zota
蹧	zozc
适	zpui
踢	zpti
迁	zpqm
遛	zplq
踄	zpue
逛	zqgl
趄	zqqp
趄	zqju
趑	zqzi
迤	zryi
迕	zrwu
迮	zrze
逻	zslo
迨	zsdd
跬	ztkv
蹯	ztfj
蹓	ztlq
蹚	ztth
赶	zugj
迟	zuii
跸	zubi
踔	zuio
趕	zugj
躥	zucr
跑	zvpc
辽	zvln
跄	zvql
迳	zvjk
邋	zvla
邈	zvmn
孢	zvbc
跎	zvto
逯	zvlu
躐	zvlp
趷	zvke
踡	zvqr
迍	zvvy
这	zwve
这	zwvw
逄	zwph
赵	zxvc
孙	zxsy
蹩	zxbp
跽	zxji
迆	zxyi
迆	zxto
踱	zydo
蹑	zynp
蹋	zyta
躞	zyxp
䟴	zyvf
逊	zzxy
跹	zzxm
踺	zzjm
跶	zzda
躂	zzda
躚	zzxm
孖	zzzi
孖	zzma
