一	tiiy
丁	tiid
丂	ts
七	tiiq
七	tiic
丄	lii
丅	tii
丆	jii
万	thbw
万	thaw
丈	xnaz
三	eii
上	lii
下	tybs
下	tyax
下	tdbs
下	tdax
下	tdas
丌	tn
不	jyab
与	siiy
丏	tlj
丐	tts
丑	jxt
丒	ddt
专	fsdz
且	qfaq
且	qfac
丕	jyt
世	hlas
丘	giiq
丙	tnv
业	wt
丛	vvt
东	tmad
丝	wwt
丞	jxt
丠	ktt
両	tne
丢	jlgd
两	tnvv
严	twj
並	vwt
丧	xvk
丨	iii
个	vibg
个	viag
丫	yiiy
丬	kii
中	oiaz
丮	zf
丰	fiif
丱	hii
串	ooi
丳	oon
临	nkb
丵	wty
丵	wtvx
丶	dii
丷	vii
丸	xdaw
丹	ndad
为	djd
主	de
丼	fnd
丽	tndd
举	wvf
丿	jii
乀	nii
乁	zii
乂	xii
乃	zj
久	rn
乇	jtbt
么	jgbm
么	jgam
义	dxay
之	dzbz
之	dzaz
乌	sst
乍	lkbz
乎	jvi
乏	jdz
乐	cmal
乑	xii
乒	gjbp
乓	gdbp
乔	jyn
乕	jjfi
乖	jxkt
乗	jthm
乘	jxkv
乙	ziiy
乚	lii
乛	jii
乜	ciim
九	xiij
乞	lzbq
也	ciiy
习	jiix
习	jiis
乡	wjax
乡	wjas
乢	el
乣	wl
乤	tdz
乥	jvz
书	jjid
乧	ddxz
乨	gol
乩	yol
乪	zq
乫	joz
乬	gz
乭	cz
乮	cjpz
乯	jviz
买	jddy
乱	jxol
乲	vrvz
乳	jzl
乴	fjjz
乵	dxl
乶	tdiz
乷	smjz
乸	cqs
乹	xbxl
乺	jjzz
乻	dhvz
乼	sdez
乽	ybz
乾	xbxz
乿	jwml
亀	rbbl
亁	xbfz
亂	jdnl
亃	xdcl
亄	lntl
亅	iii
了	jii
亇	rj
予	dt
争	rei
亊	tvej
事	toei
二	fiie
亍	fi
于	fiiy
亏	fsbk
亐	fs
云	fgby
互	tljt
亓	fnbq
五	wiiw
井	fnaj
亗	ef
亘	tbtg
亙	tjdt
亙	tijt
亙	thdt
亚	twt
些	ltf
亜	tont
亝	gggf
亞	txt
亟	joat
亠	dii
亡	dlbw
亢	dwbk
亣	dn
交	dvx
亥	dyv
亦	dmby
产	djbc
产	djac
亨	doj
亩	dqbm
亪	dmz
享	dozs
京	dom
亭	dont
亮	donw
亯	dob
亰	dbm
亱	dtbt
亲	dmbq
亲	dmbc
亳	dont
亴	donx
亵	dfxk
亶	dqot
亷	djem
亸	dozx
亹	djkf
人	viir
亻	tii
亼	vt
亽	vd
亾	vl
亿	tzuy
什	txus
仁	tfur
仂	tj
仃	ttud
仄	jvcz
仅	ta
仆	tyup
仇	txuc
仈	tv
仉	tw
今	vjbj
介	vnbj
仌	vv
仍	tzj
从	vvuc
仏	tg
仐	vx
仑	vtbl
仒	vdd
仓	vc
仔	tzuz
仕	tlus
他	tcut
仗	txn
付	txdf
仙	teux
仛	tjt
仜	ti
仝	vibt
仞	tdd
仟	tjx
仠	tf
仡	tlz
仢	tsd
代	tv
令	vjd
以	ldv
仦	tm
仧	lv
仨	teus
仩	tl
仪	tdx
仫	tjg
们	tnum
仭	tdn
仮	tjja
仯	tmj
仰	tcp
仱	tvj
仲	toi
仳	tu
仴	td
仵	tlx
件	tki
价	tvn
仸	tjy
仹	tf
仺	ve
任	tjl
仼	te
份	tvd
仾	ttlt
仿	tdh
伀	tvg
企	vlbq
企	vlbc
伂	ttni
伃	tdt
伄	tzsi
伅	ttul
伆	tss
伇	twa
伈	tu
伉	tdw
伊	tej
伋	tjzn
伌	tjc
伍	twuw
伎	txa
伏	tyd
伐	txuf
休	tmux
休	tmus
伒	tjjt
伓	tjy
伔	tnw
伕	tfv
伖	txa
众	vvvz
优	txld
伙	txuh
会	vfgh
伛	tcxy
伜	txx
伝	tfg
伞	vvi
伟	tfji
传	tfsd
伡	tc
伢	tcij
伣	tnw
伤	tlj
伥	tk
伦	tvt
伧	tvc
伨	tsv
伩	tdx
伪	tdjd
伫	tntz
伬	tpn
伭	tdw
伮	tra
伯	tgub
估	txog
伱	tvm
伲	tpt
伳	thl
伴	tvx
伵	tq
伶	tvjd
伷	td
伸	tbi
伹	tqf
伺	tjto
伻	ttvi
似	tldv
伽	tjo
伾	tjyt
伿	tov
佀	tpz
佁	tgo
佂	ttl
佃	tqud
佄	thf
佅	tfm
但	tbtd
佇	tnt
佈	txni
佉	tlg
佊	tja
佋	tdo
佌	tlt
位	tduw
低	tctd
住	tde
佐	txi
佑	txoy
佒	tny
体	tmt
佔	tyo
何	tto
佖	tuj
佗	tntt
佘	vfm
余	vtmy
佚	tkv
佛	tzsn
作	tlk
佝	tso
佞	tfr
佟	tadd
你	trm
佡	tve
佢	tg
佣	tnf
佣	tdi
佤	ttld
佥	vtw
佦	tc
佧	tly
佨	tse
佩	twti
佪	tqo
佫	tao
佬	tyt
佭	taci
佮	tvto
佯	tvf
佰	tjbb
佱	vfl
佲	tdo
佳	tll
佴	tp
併	tvh
佶	tlo
佷	tek
佸	tjxo
佹	trjc
佺	tve
佻	tvwv
佼	tdvx
佽	tvrv
佾	tvd
使	ttox
侀	tthn
侁	tjlw
侂	tjjt
侃	tomk
侄	ttgl
侅	tdyv
來	xvvv
來	tvvm
侇	ttzv
侈	tdd
侉	tyfs
侊	tww
例	ttdn
侌	vjfg
侍	tlxd
侎	tx
侏	tkm
侐	tjq
侑	txd
侒	tnr
侓	tef
侔	tgki
侕	tjnn
侖	vtnh
侗	tnto
侘	tnjt
侙	ttiv
侚	tsb
供	thv
侜	tns
依	tdk
侞	tro
侟	txiz
侠	ttvv
価	tc
侢	ttnl
侣	too
侤	tys
侥	txtw
侦	tybz
侧	tbn
侨	tjyn
侩	tvfg
侪	tdxn
侫	tdlr
侬	tpk
侭	tpnd
侮	tlqs
侯	tzly
侰	tejo
侱	toe
侲	tjfk
侳	tvvl
侴	vtjn
侵	tena
侶	tojo
侷	tpjo
侸	ttov
侹	tjlz
侺	tevj
侻	tvow
侼	txnz
侽	tqj
侾	tyz
便	ttbx
俀	tjr
俁	tosy
係	tjwm
促	tol
俄	tjfx
俅	txxd
俆	tvtm
俇	txje
俈	tjlo
俉	two
俊	tgva
俋	todl
俌	ttdd
俍	tdek
俎	vvqf
俏	twd
俐	thn
俑	tdnf
俑	tddi
俒	tnfw
俓	ttsi
俔	tgw
俕	tnm
俖	tjyo
俗	tvvo
俘	tjz
俙	txxi
俚	tbl
俛	trow
俜	tdts
保	tom
俞	vtdn
俟	tgly
俠	tyvv
俠	ttvv
信	tiux
信	tius
俢	tas
俣	toty
俤	tvzj
俥	tc
俦	tfxd
俧	tlu
俨	ttwj
俩	ttnv
俪	ttnd
俫	ttx
俬	thg
俭	tvtw
修	tias
俯	tjtd
俰	tho
俱	tqev
俲	tdvj
俳	tene
俴	txx
俵	tlk
俶	tlma
俷	tddl
俸	tevf
俹	ttxt
俺	tybl
俻	taq
俼	tdgd
俽	tjjv
俾	tgjx
俿	tyw
倀	tk
倁	tlyo
倂	tjff
倃	tayo
倄	txxd
倅	tdvx
倆	ttnd
倇	tndc
倈	txvv
倉	vdeo
倊	tvgu
個	tqxo
倌	tnpz
倍	tdo
倎	tuv
倏	tiad
倐	tiax
們	tn
倒	ttgn
倓	txx
倔	tpue
倕	tjxf
倕	tjtl
倖	tly
倖	tlvx
倗	tdd
倘	twno
候	tizy
倚	tyto
倛	thev
倜	tnlo
倝	xbxv
倞	tdom
借	thb
倠	tti
倡	tbb
倢	ttel
倣	tdha
値	txgl
倥	tnvi
倦	tvyc
倧	tnfm
倨	tpxo
倩	tld
倪	tgw
倫	tvth
倬	tybx
倭	thr
倮	tbm
倯	tmvg
倰	tlva
倱	tbu
倲	ttbm
倳	ttoi
倴	tyxh
倵	tflv
倶	tgtv
倷	tyfm
倸	tjm
倹	tvtv
债	tlb
倻	tpp
值	txqe
倽	tvfo
倾	ttlb
倿	tdr
偀	thny
偁	tjnl
偂	tvdn
偃	tcbr
偄	tjny
偅	tjtl
偆	tevb
假	tpfa
偈	tbsl
偉	tzii
偊	tjog
偋	tpvh
偌	thxo
偍	tbtl
偎	tqtk
偏	tdph
偐	tdjs
偑	twjq
偒	tbts
偒	tbjs
偓	tptl
偔	toos
偕	tug
偖	tyb
偗	tmjg
偘	tooo
偙	tdni
做	txoa
偛	tjxg
停	tdot
偝	tktd
偞	thlm
偟	tge
偠	tcr
偡	thel
偢	thx
偣	tdb
偤	tvu
健	tefz
偦	tjld
偧	tydd
偨	tltm
偩	trgv
偪	ttoq
偫	tsld
偬	tssu
偭	tjqf
偮	top
偯	tdok
偰	tfdy
偱	tjjg
偲	tqu
偳	tejn
側	tgvn
偵	tygv
偶	tbng
偷	tvtn
偸	tvtk
偹	tiaq
偺	tayb
偻	txr
偼	tyel
偽	tdjh
偾	txhb
偿	twng
傀	tgwg
傁	tgia
傂	tjjw
傃	tlwm
傄	tyvg
傅	ttdd
傆	tjgm
傇	thp
傈	tcm
傉	tjfd
傊	togv
傋	tfnl
傌	tsh
傍	tdnh
傎	txqv
傏	tjeo
傐	tdoo
傑	tdcm
傒	tjwy
傓	tdpj
傔	tvem
傕	tpii
傖	tvdo
傗	tdwq
傘	vvvx
備	thjf
傚	tdva
傛	tnvo
傜	tjlu
傝	tbjj
傞	tvfi
傟	tvgj
傠	tixd
傡	tdd
傢	tnx
傣	tevs
傤	tlcx
傥	twnw
傦	tqd
傧	tngv
储	tiyb
傩	tati
傪	tggs
傫	tqwm
催	teti
傭	tjei
傮	tub
傯	tjqu
傰	tedd
傱	tsvl
傲	tlha
傳	ttbd
傴	tcoo
債	tlgv
傶	tjlx
傷	tlbs
傸	tyxx
傹	tdbw
傺	txfm
傻	tjqa
傼	thov
傽	tdbx
傾	ttlv
傿	ttlh
僀	thwi
僀	thni
僁	tjxu
僂	totr
僃	thsf
僄	tcfm
僅	thol
僆	tcz
僇	tjjs
僈	tbqa
僉	vtov
僊	tcye
僋	tvjv
僌	tca
働	tjtj
僎	teev
像	trox
像	trbx
僐	tvfo
僑	tjyo
僒	tnvo
僓	tqgv
僔	tvud
僕	twtv
僖	tloo
僗	txxj
僘	twna
僙	thdv
僚	tyvm
僛	thev
僜	txtv
僝	tpzz
僞	tjjh
僟	twwx
僠	tjxq
僡	ttbu
僢	tjni
僣	tfvb
僤	toox
僥	tllw
僦	tdod
僧	tvqb
僨	txhv
僩	tnd
僪	tdto
僫	ttxu
僬	ttih
僭	tcwb
僮	tdbl
僯	txdi
僰	tnmv
僱	tdpi
僲	tcdi
僳	tcxs
僴	tnb
僵	ttqt
僶	tq
僷	thhm
僸	tmmm
價	tcgv
僺	toom
僻	tpox
僼	tutv
僽	thxu
僾	tjna
僿	tnfl
儀	tvex
儁	ttim
儂	tujk
儃	tdqt
億	tdbu
儅	twnq
儆	thsa
儇	tqtk
儈	tvtb
儉	tvtv
儊	tmml
儋	trji
儌	tgda
儍	tdxa
儎	tlcx
儏	tydx
儐	tntv
儑	tbwh
儒	tujn
儓	tlol
儔	tljd
儕	tddh
儖	tgkq
儗	ttll
儘	telq
儘	teiq
儙	tqpz
儚	thqd
儛	tlhi
儜	tnut
儝	txxm
儞	ttvx
償	twnv
儠	tsqv
儡	tqqq
儢	tyqu
儣	tjhv
儤	tbhs
儥	tlqv
儦	tjzh
儧	tfvv
儨	tjjv
儩	tgvs
優	tjqa
優	tjna
儫	tdox
儬	tldw
儭	tdmw
儮	tjhl
儯	tvyh
儰	thjh
儱	tdde
儲	tiyb
儳	trod
儴	tdok
儵	tiah
儶	teto
儷	ttnu
儸	tqwi
儹	tjlv
儺	thoi
儻	twnh
儼	tooa
儽	tqqm
儾	ttok
儿	wiie
兀	tw
允	gwby
兂	cw
元	fw
兄	owbx
兄	owbs
充	dgw
兆	vwv
兇	xuw
先	jlwx
先	jlws
光	ww
兊	vgw
克	xow
兌	vow
免	row
兎	jowd
兏	jlw
児	ibw
兑	vow
兒	gw
兓	cwcw
兔	rowd
兕	uw
兖	dvgw
兗	dvow
兘	fwgo
兙	xowx
党	wnow
兛	xowx
兜	cgzw
兝	xowd
兞	xowl
兟	jlww
兠	kgtw
兡	xowb
兢	xoww
兣	xowl
兤	wwjv
入	jnar
兦	jnl
內	njn
全	vebq
全	vebc
兩	tnid
兪	vtdl
八	viib
公	vgbg
公	vgag
六	dvbl
兮	vts
兯	vp
兰	vebl
共	hvbg
兲	ev
关	vybg
兴	wv
兵	gvbb
其	hev
具	qev
典	uv
兹	vww
兺	vdot
养	vevn
兼	vem
兽	vqto
兾	vqhv
兿	vfxg
冀	ktqv
冁	vbxk
冂	nii
冃	nf
冄	nf
内	nvan
円	nit
冇	xn
冈	nxcg
冉	nl
冊	nh
冋	no
册	nntc
再	tnl
冎	qii
冏	nvo
冐	nfd
冑	dnf
冒	nfg
冒	bgbm
冓	fntl
冔	bof
冕	brow
冖	nii
冗	nwbr
冘	pl
写	nsbx
写	nsbs
冚	ne
军	ncbj
农	pk
冝	nqf
冞	nx
冟	ngt
冠	nfwd
冡	nfx
冢	nxdz
冣	npa
冤	nrod
冥	nbdv
冦	nfwa
冧	nmm
冨	ntoq
冩	ngsh
冪	nhbi
冫	vii
冬	add
冭	ydd
冮	vi
冯	vst
冰	vsub
冱	vtlt
冲	voic
决	vzv
冴	vcij
况	vowk
冶	vgo
冷	vvjd
冸	vvx
冹	vxad
冺	vptv
冻	vtmd
冼	vjlw
冽	vtdn
冾	vvto
冿	vef
净	vrei
凁	vtom
凂	vrow
凃	vvtm
凄	vter
凅	vqxo
准	vtiz
凇	vmvg
凈	vjei
凉	vdom
凊	vld
凋	vnlo
凌	vlva
凍	vtbm
凎	vv
减	vjtx
凐	vcl
凑	vevy
凒	vetv
凓	vcm
凔	vvdo
凕	vnbv
凖	vtix
凗	veti
凘	vhet
凙	vqlx
凚	vmmm
凛	vdqm
凜	vdqm
凝	vtll
凞	vjgh
凟	vlqv
几	wiij
凡	wdcf
凡	wdaf
凢	jw
凣	iw
凤	wacf
凥	pw
処	aw
凧	wni
凨	wfg
凩	wm
凪	wl
凫	gw
凬	wtb
凭	tjlw
凮	wjb
凯	ezlw
凰	wge
凱	etow
凲	wvem
凳	xtow
凴	vshw
凵	uii
凶	xu
凷	lu
凸	diit
凹	uiia
出	ueac
击	fucj
击	fuaj
凼	sucd
函	jxuh
凾	joau
凿	wtyu
凿	wtvu
刀	diid
刁	jtad
刂	nii
刃	ddar
刄	dn
刅	dv
分	vdbf
切	tduq
切	tduc
刈	xnuy
刉	lzn
刊	fnuk
刋	jxn
刌	xdn
刍	re
刎	ssn
刏	kzn
刐	ndn
刑	thnx
刑	thns
划	xnuh
刓	fwn
刔	zvn
刕	ddd
刖	dn
列	tdn
刘	dxnl
则	bn
刚	nxn
创	vcn
刜	zsnn
初	jkdc
刞	qfn
刟	don
删	nntn
刡	ptvn
刢	vjdn
刣	gon
判	vxn
別	ohn
刦	lgn
刧	lgd
刨	sen
利	hnul
刪	nhn
别	ojn
刬	fxn
刭	zin
刮	jxon
刯	tbtn
到	tgln
刱	fndv
刲	lln
刳	yfsn
刴	zjmn
刵	pn
制	knin
刷	pnin
券	vydq
券	vydc
刹	xmn
刺	tnmn
刻	dyvn
刼	lgdd
刽	vfgn
刾	tvvn
刿	edn
剀	ezln
剁	wmn
剂	dxnn
剃	vzsn
剄	tsin
剅	tovn
剆	degn
則	gvn
剈	odn
剉	vvln
削	wdn
剋	xown
剌	tomn
前	vdn
剎	xmdn
剏	vhdd
剐	onvn
剑	vtwn
剒	hbn
剓	hsjd
剔	bssn
剕	enen
剖	don
剗	xxn
剘	hevn
剙	vhdv
剚	toen
剛	nven
剜	ndcn
剝	ljtn
剞	yton
剟	aaan
剠	domn
剡	xxn
剢	xdn
剣	vton
剤	dxhn
剥	esn
剦	ybln
剧	pxon
剨	fcn
剩	jxkn
剪	vdnd
剫	jhan
剬	ejnn
剭	ptgn
剮	qon
副	toqn
剰	jxhn
剱	vtod
割	nfon
剳	hvtn
剴	eton
創	vden
剶	ljxn
剶	ljtn
剷	djjn
剸	tbgn
剹	jjvn
剺	fmad
剻	eddn
剼	gggn
剽	cfmn
剾	coon
剿	sbmn
劀	dtjn
劁	tihn
劂	jvun
劃	elqn
劄	kvtn
劅	qsqn
劆	jven
劇	yxn
劈	podd
劉	gdvn
劊	vtqn
劋	ooon
劌	ljtn
劍	vton
劎	vtod
劏	wnon
劐	htin
劑	dydn
劑	ddyn
劒	vtod
劓	jgqn
劔	vton
劕	jjtn
劖	roun
劗	jlwn
劘	jmmn
劙	ljxn
劙	ljtn
劚	psqn
力	jiil
劜	jl
劝	ajuq
劝	ajuc
办	jvab
功	ij
加	jouj
务	ajbw
劢	thj
劣	mjj
劤	jjtj
劥	dwj
劦	jjj
劧	jfj
动	fgj
助	qfj
努	raj
劫	lgj
劬	soj
劭	dojs
劮	kvj
劯	cj
劰	gj
励	jthj
劲	zij
劳	hnj
労	wnj
劵	vyj
劶	jjtj
劷	vfj
劸	llj
効	dvxj
劺	gkij
劻	cej
劼	loj
劽	tdnj
劾	dyvj
势	fxdj
勀	xowj
勁	tsij
勂	jloj
勃	xnzj
勄	lqsj
勅	tomj
勆	degj
勇	dnfj
勇	ddij
勈	dnfj
勉	rowj
勊	xowj
勋	obj
勌	vycj
勍	domj
勎	lvlj
勏	doj
勐	zqj
勑	xvvj
勑	tvvj
勒	hpj
勓	ugj
勔	jqnj
動	jtbj
勖	nfgj
勖	bgj
勗	bqfj
勘	hevj
務	dtjj
勚	hlbj
勛	ogvj
勜	vgjj
勝	dvyj
勞	xxnj
募	hbyj
勠	jjvj
勡	cfmj
勢	lvlj
勣	lgvj
勤	holj
勥	zsoj
勦	sbmj
勧	lxij
勨	roxj
勩	hlgj
勪	jyoj
勫	jxqj
勬	vywj
勭	dblj
勮	yxj
勯	dqoj
勰	jjju
勱	hbnj
勲	jtbh
勳	jtqj
勴	yquj
勵	jhbj
勶	sdgj
勷	dooj
勸	hooj
勹	sii
勺	sdcs
勻	sf
勼	sx
勽	sv
勾	sgcg
勿	sscw
勿	ssaw
匀	svcy
匀	svay
匁	sx
匂	st
匃	svl
匄	sdl
包	secb
包	seab
匆	ssd
匇	sd
匈	sxus
匉	stvi
匊	sx
匋	slxu
匌	svto
匍	stdd
匎	sybl
匏	yfse
匐	stoq
匑	srzs
匒	shvo
匓	sega
匔	sroo
匕	tiib
化	ttuh
北	kt
匘	tlsx
匙	btlt
匚	cii
匛	crd
匜	cc
匝	cni
匞	ci
匟	cdw
匠	cjjt
匡	ce
匢	css
匣	cq
匤	ced
匥	cgh
匦	ccx
匧	cyvv
匧	ctvv
匨	ckl
匩	cuie
匪	cene
匫	cssb
匬	cvtn
匭	ccx
匮	cqb
匯	csti
匰	coox
匱	cqgv
匲	cyoo
匳	cvtv
匴	ckgh
匵	clqv
匶	chtg
匷	cggi
匸	cii
匹	cwcp
区	cxcq
区	cxcc
医	cly
匼	cvto
匽	cbr
匾	cdph
匿	chxo
區	cooo
十	xiis
卂	zx
千	jxbq
千	jxbc
千	jxaq
千	jxac
卄	hii
卅	hii
卆	xx
升	jh
午	lxbw
卉	xh
半	vxab
卋	xh
卌	hii
卍	xii
华	ttx
协	xjv
卐	xii
卑	gjx
卒	dvvx
卓	ybx
協	xjjj
单	vbx
卖	xjdy
南	xny
南	xnvx
単	wbx
卙	hevx
博	xtdd
卛	wmix
卜	yii
卝	hii
卞	dybb
卟	oyub
占	yobz
占	yoaz
卡	lybk
卢	ypbl
卣	yqz
卤	yqx
卥	yqsd
卦	llyg
卧	gy
卨	yqo
卩	pii
卪	pd
卫	ptbw
卫	ptaw
卬	cp
卭	ip
卮	jjtc
卯	cjp
印	epuy
印	ctp
危	rjc
卲	dop
即	egp
却	lgp
卵	cypd
卶	ddp
卷	vyc
卸	lxtp
卹	jqp
卺	jxtc
卻	vvop
卼	twrc
卽	gtp
卾	oofp
卿	cjep
厀	mvsp
厁	vtmp
厂	jiic
厃	rj
厄	jcce
厅	jtc
历	jj
厇	jjt
厈	jf
厉	jth
厊	jcij
压	jldy
厌	jyd
厍	jccs
厎	jctd
厏	jlk
厐	jxtd
厑	jot
厒	jlxu
厓	jll
厔	jtgl
厕	jbn
厖	jxld
厗	jdx
厘	jbl
厙	jc
厚	jbz
厛	jojt
厜	jjxf
厜	jjtl
厝	jhb
厞	jnee
厞	jene
原	jgmy
厠	jgvn
厡	jgs
厢	jmg
厣	jydq
厤	jhh
厥	jvuv
厦	jjga
厧	jxqv
厨	jtod
厩	jegw
厪	jhol
厫	jlha
厬	jbao
厭	jbdd
厮	jhet
厯	jmmd
厰	jwna
厱	jvtv
厲	jhbg
厳	wjja
厴	jbdq
厵	jgmm
厶	giis
厷	xg
厸	gg
厹	xg
厺	yg
去	lgbq
去	lgbc
厼	gm
厽	ggg
厾	zlg
县	qfg
叀	tbig
叁	gye
参	gys
參	gggs
叄	ggge
叅	gggd
叆	fgja
叇	fgez
又	aiiy
叉	ad
及	jzn
友	xacy
友	xaay
双	aa
反	jjaf
収	lia
叏	zia
叐	jxa
叐	fa
发	yad
叒	aaa
叓	toia
叔	lma
叕	aaaa
取	pa
受	jna
变	dma
叙	vtma
叚	pfza
叛	vxja
叜	nxa
叝	lgpa
叞	pfma
叟	gia
叠	aaaf
叡	ynta
叢	wtva
口	oiik
古	xobg
句	socj
另	oj
叧	od
叨	odud
叩	opuk
只	ovbz
叫	oli
召	dobz
叭	ovub
叮	otud
可	to
台	go
叱	otuc
史	oxas
右	xocy
叴	xo
叵	cocp
叶	oxuy
号	ots
司	jtos
叹	oaut
叺	ojn
叻	ojul
叼	ojt
叽	owuj
叾	jo
叿	oi
吀	ojx
吁	of
吂	dlo
吃	olz
各	ao
吅	oo
吆	owuy
吇	oz
合	vto
吉	lo
吊	oni
吋	oxd
同	nto
名	dobm
后	jjto
吏	tox
吐	olut
向	jno
吒	ojtz
吓	otd
吔	oc
吕	oobl
吖	oyua
吗	ost
吘	olx
吙	ox
吚	oej
君	ejoj
吜	ojxt
吝	dxo
吞	tyo
吟	ovj
吠	oydf
吡	ou
吢	uo
吣	ou
吤	ovn
吥	ojy
否	jyof
吧	odlb
吨	otul
吩	ovd
吪	ott
含	vjo
听	ojjt
吭	odw
吮	ogw
启	dpo
吰	oxg
吱	oxa
吲	ozsi
吳	osy
吴	oty
吵	omj
吶	onjn
吷	ozv
吸	ojzn
吹	orv
吺	owa
吻	oss
吼	ozl
吽	oki
吾	wo
吿	kio
呀	ocij
呁	osv
呂	ojo
呃	ojc
呄	zjxo
呅	odx
呆	om
呇	so
呈	oe
呉	ostv
告	jlo
呋	ofv
呌	oddx
呍	ofg
呎	opn
呏	ojh
呐	onv
呑	jyo
呒	ofl
呓	ohz
呔	oydt
呕	ocx
呖	ojj
呗	obub
员	obby
呙	onv
呚	oa
呛	ovc
呜	osst
呝	odpz
呞	ojto
呟	odw
呠	omt
呡	optv
呢	opt
呣	oqs
呤	ovjd
呥	onl
呦	owj
呧	octd
周	nlo
呩	ofm
呪	oow
呫	oyo
呬	oq
呭	ohl
呮	oov
呯	otvi
呰	lto
呱	ojjn
呲	olt
味	ofm
呴	oso
呵	oto
呶	ora
呷	oqux
呷	oqus
呸	ojyt
呹	okv
呺	oots
呻	obi
呼	ojvi
命	vtop
呾	obt
呿	olg
咀	oqf
咁	ohf
咂	ocni
咃	otc
咄	oue
咅	do
咆	ose
咇	ouj
咈	ozsn
咉	ony
咊	oh
咋	olk
和	ho
咍	ogo
咎	ayo
咏	odjx
咐	otxd
咑	oft
咒	oow
咓	otld
咔	oly
咕	oxo
咖	ojo
咗	oxi
咘	oxni
咙	oxtd
咚	oadd
咛	ont
咜	ont
咝	owwt
咞	oth
咟	ojb
咠	op
咡	op
咢	oofs
咣	oww
咤	onjt
咥	otgl
咦	otzv
咧	otdn
咨	vrvo
咩	ovf
咪	oxum
咫	pnov
咬	odvx
咭	olo
咮	okm
咯	oao
咰	osb
咱	ojg
咲	ovy
咳	odyv
咴	oxx
咵	oyfs
咶	ojxo
咷	ovwv
咸	jtox
咹	onr
咺	otbt
咻	otm
咼	qo
咽	oqy
咾	oyt
咿	otej
哀	dok
品	ooo
哂	ocus
哃	onto
哄	ohv
哅	osxu
哆	odd
哇	oll
哈	ovto
哉	lox
哊	oxd
哋	olc
哌	ojjk
响	ojno
哎	ohx
哏	oek
哐	oce
哑	otwt
哒	oyzd
哓	oxtw
哔	oux
哕	oed
哖	olci
哗	ottx
哘	osfi
哙	ovfg
哚	owm
哛	otvd
哜	odxn
哝	opk
哞	ogki
哟	owsd
哠	ojlo
員	ogv
哢	oeh
哣	otov
哤	oxld
哥	toto
哦	ojfx
哧	olm
哨	owd
哩	obll
哪	odfp
哫	ool
哬	otto
哭	ooyd
哮	oyzx
哮	oyzs
哯	ogw
哰	onki
哱	oxnz
哲	fjjo
哳	ofjt
哴	odek
哵	oojn
哶	ohf
哷	ojxd
哸	ojr
哹	ojz
哺	otdd
哻	obf
哼	odoj
哽	otbx
哾	ovow
哿	joto
唀	ohzj
唁	oiuy
唂	ovvo
唃	or
唄	ogv
唅	ovjo
唆	ogva
唇	jfko
唈	oodl
唉	ogly
唊	oyvv
唊	otvv
唋	ovtm
唌	ojlz
唍	onfw
唎	ohn
唏	oxxi
唐	jeio
唑	ovvl
唒	ou
唓	oc
唔	owo
唕	ogx
唖	otot
唗	oll
唘	cao
唙	oxjx
唚	oena
唛	ola
唜	tmot
唝	oib
唞	ofdx
唟	lgot
唠	ohnj
唡	otnv
唢	owb
唣	ogt
唤	orny
唥	ovvd
唦	osmj
唧	oegp
唨	opqf
唩	ohr
唪	oevf
唫	ov
唬	oyw
唭	ohev
售	tio
唯	oti
唰	opnn
唱	obb
唲	ogw
唳	odpd
唴	ovfl
唵	oybl
唶	ohb
唷	odgd
唸	ovju
唹	odhd
唺	ouv
唻	oxvv
唼	odr
唽	omjt
唾	ojxf
唾	ojtl
唿	ossu
啀	ojll
啁	onlo
啂	ojzl
啃	old
啄	oxd
啅	oybx
商	dnvo
啇	dnxo
啈	oly
啈	olvx
啉	omm
啊	opto
啋	ojm
啌	onvi
啍	odoz
啎	lxwo
問	nno
啐	odvx
啑	otel
啒	opue
啓	dpao
啔	dpxo
啕	oslu
啖	oxx
啗	org
啘	ondc
啙	ltoo
啚	oxqo
啛	oter
啜	oaaa
啝	oho
啞	otxt
啟	dpoa
啠	jjto
啡	oene
啢	otnd
啣	olxp
啣	oltp
啤	ogjx
啥	ovfo
啦	ofd
啧	olb
啨	old
啩	olly
啪	ofg
啫	oyb
啬	xvqo
啭	ocfd
啮	olw
啮	olvu
啯	oqed
啰	oqd
啱	oec
啲	ogsd
啳	ovyc
啴	ovbx
啵	osja
啶	ontl
啷	odep
啸	oemn
啸	oeii
啹	opxo
啺	obts
啺	objs
啻	dnno
啼	odni
啽	ovth
啾	ohx
啿	ohel
喀	onao
喁	obng
喂	oqtk
喃	oxny
喃	oxnx
善	vfvo
喅	obd
喆	lolo
喇	oton
喈	oug
喉	otzy
喊	ojtx
喋	ohlm
喌	ooyy
喍	oltm
喎	oqo
喏	ohxo
喐	oxdp
喑	odb
喒	oayb
喓	ocr
喔	optl
喕	ojqf
喖	omxo
喗	onc
喘	oejn
喙	oljx
喚	orny
喛	ojfa
喜	lovo
喝	obsl
喞	ogtp
喟	oqd
喠	ojtl
喡	ozii
喢	ojxg
喣	osoh
喤	oge
喥	ojha
喦	oooe
喧	ontt
喨	odow
喩	ovtk
喪	xook
喫	ofdy
喬	jyoo
喭	odjs
單	oobx
喯	oyxh
喰	ovdk
喱	ojbl
喲	owmd
喳	ombt
喴	ojtx
喵	ohq
営	wnoo
喷	oxhb
喸	tdit
喹	oyll
喺	otjm
喻	ovtn
喼	oreu
喽	oxr
喾	wnjo
喿	ooom
嗀	lnta
嗁	ojjw
嗂	ojlu
嗃	odoo
嗄	ojga
嗅	ojgd
嗆	ovdo
嗇	xvvo
嗈	osol
嗉	olwm
嗊	oigv
嗋	ojjd
嗌	ovvq
嗍	ovud
嗎	osh
嗏	ohvm
嗐	onfo
嗑	olgq
嗒	ohvo
嗓	oaam
嗔	oxqv
嗕	ojfd
嗖	ogia
嗗	oqd
嗘	ojwy
嗙	odnh
嗚	ojzh
嗛	ovem
嗜	oytb
嗝	otoy
嗞	ovww
嗟	ovfi
嗠	jzao
嗡	ovgj
嗢	obq
嗣	onho
嗤	oulq
嗤	ouiq
嗥	ogyx
嗦	oxnm
嗧	jovh
嗨	osls
嗩	owgv
嗪	oevh
嗫	opaa
嗬	ohto
嗭	xqet
嗮	obc
嗯	oqyu
嗰	otqo
嗱	ovtf
嗲	ovxd
嗳	ojna
嗴	ovfg
嗵	odnz
嗵	oddz
嗶	obhf
嗷	olha
嗸	lhao
嗹	ocz
嗺	oeti
嗻	ojhh
嗼	ohby
嗽	otov
嗾	odhy
嗿	ovjv
嘀	odno
嘁	ojlx
嘂	oolo
嘃	ojei
嘄	ogm
嘅	oegw
嘆	ohov
嘇	oggs
嘈	oub
嘉	lovo
嘊	oejl
嘋	oyza
嘌	ocfm
嘍	ootr
嘎	ojgx
嘏	xopa
嘐	ojjs
嘑	oyji
嘒	offe
嘓	oqtx
嘔	ocoo
嘕	otlh
嘖	olgv
嘗	wnob
嘘	oywt
嘙	osjr
嘚	osbd
嘛	ojmm
嘜	oxva
嘝	ordx
嘞	ohpj
嘟	oybp
嘠	ojqx
嘡	ownl
嘢	oblt
嘣	oedd
嘤	obbr
嘥	osll
嘦	ovcr
嘧	onue
嘨	oeji
嘩	ohtf
嘪	oqgv
嘫	odyh
嘬	obpa
嘭	olos
嘮	oxxj
嘯	oexk
嘰	owwx
嘱	opjg
嘲	oxbd
嘳	oqgv
嘴	oltr
嘵	ollw
嘶	ohet
嘷	ojgx
嘸	olhh
嘹	oyvm
嘺	ojyo
嘻	oloo
嘼	ooqo
嘽	ooox
嘾	ocbx
嘿	oqh
噀	oeev
噁	otxu
噂	ovud
噃	ojxq
噄	ofdm
噅	ojjh
噆	ocwb
噇	odbl
噈	odod
噉	ojpa
噊	odto
噋	odoa
噌	ovqb
噍	otih
噎	olnv
噏	ovtj
噐	ooio
噑	ogxx
噒	oxdi
噓	oywt
噔	oxtv
噕	jjjo
噖	oeej
噗	owtv
噘	ojvv
噙	ovdg
噚	oeid
噛	olxu
噜	ortb
噝	owmm
噞	ovtv
噟	jtto
噠	olvz
噡	orji
噢	ojny
噣	oqsq
噤	ommm
噥	oujk
噦	oljx
噧	ohbg
器	ooyo
噩	eooo
噪	ooom
噫	odbu
噬	okiv
噭	ogda
噮	oqtk
噯	ojna
噰	odwi
噱	oyx
噲	ovtb
噳	oyoy
噴	oxhv
噵	vjgo
噶	ohbl
噷	odbv
噸	otuv
噹	ownq
噺	odmt
噻	onfl
噼	opox
噽	lovt
噾	onvb
噿	ojjx
嚀	onut
嚁	ojji
嚂	ogkq
嚃	oqsz
嚄	ohta
嚅	oujn
嚆	ohdo
嚇	olmm
嚈	ojbd
嚉	owtd
嚊	ojgn
嚋	oljd
嚌	oddh
嚍	oelq
嚍	oeiq
嚎	odox
嚏	oxnl
嚐	ownb
嚑	ojth
嚒	ojmw
嚓	onxm
嚔	oxnl
嚕	orhb
嚖	offu
嚗	obhs
嚘	ojqa
嚘	ojna
嚙	olvu
嚚	oogo
嚛	owgm
嚜	oqhl
嚝	ojhv
嚞	lolo
嚟	ohss
嚠	ogdn
嚡	ohpl
嚢	toik
嚣	oojo
嚤	ojmf
嚥	ohoh
嚥	ohkh
嚦	ojhl
嚧	oyqq
嚨	odde
嚩	owmd
嚪	onrg
嚫	odmw
嚬	oyjv
嚭	lovo
嚮	wjdo
嚯	outi
嚰	ojmc
嚱	oytx
嚲	dozx
嚳	jkxo
嚴	ooja
嚵	orod
嚶	ogvr
嚷	odok
嚸	oqho
嚹	olxi
嚺	oqvz
嚻	oojo
嚼	ojqd
嚽	olhv
嚾	ohoi
嚿	ohtg
囀	octd
囁	oppp
囂	oojo
囃	odvi
囄	odxi
囅	oobk
囆	ohbq
囇	otnu
囈	ohlg
囉	oqwi
囊	toik
囋	ojlv
囌	ohrh
囍	lovo
囎	ogvb
囏	hofo
囐	oytd
囑	opsq
囒	ohnm
囓	ofdu
囔	otok
囕	ogkw
囖	okqi
囗	qii
囘	ne
囙	qz
囚	qv
四	qiis
囜	qg
囝	qz
回	qoch
囟	jqx
因	qycy
囡	qr
团	qxj
団	qxd
囤	qtul
囥	qdw
囦	qs
囧	qvn
囨	qjy
囩	qfg
囪	jqsd
囫	qss
囬	qnf
园	qfw
囮	qtt
囯	qe
困	qmck
囱	jqd
囲	qfn
図	qddx
围	qfji
囵	qvt
囶	qvl
囷	qh
囸	qtl
囹	qvjd
固	qxog
囻	qptv
囼	qgo
国	qed
图	qadd
囿	qxd
圀	qvdh
圁	qi
圂	qx
圃	qtdd
圄	qwo
圅	dqvx
圆	qob
圇	qvth
圈	qvyc
圉	qly
圉	qlvx
圊	qldq
國	qtox
圌	qejn
圍	qzii
圎	qggv
圏	qvyl
圐	qqdh
圑	qtdd
園	qlok
圓	qogv
圔	qlgq
圕	qelb
圖	qoxo
圗	qgxf
團	qtbd
圙	qvjf
圚	qqgv
圛	qqly
圛	qqlx
圜	qqtk
圝	qwmm
圞	qwmm
土	liit
圠	ll
圡	ld
圢	lt
圣	al
圤	ly
圥	lw
圦	ljn
圧	jl
在	xil
圩	lf
圪	llz
圫	ljt
圬	lfs
圭	llbg
圮	lzl
圯	le
地	lcud
圱	jxl
圲	ljx
圳	lmuz
圴	lsd
圵	ll
圶	yl
圷	ltd
圸	le
圹	lj
场	lzs
圻	ljjt
圼	bl
圽	lss
圾	ljzn
圿	lvn
址	lluz
坁	lctv
坂	ljja
坃	lfw
坄	lwa
坅	lvj
坆	la
均	lsv
坈	lnw
坉	ltul
坊	ldh
坋	lvd
坌	vdl
坍	lnd
坎	lrv
坏	ljy
坐	vvl
坑	ldw
坒	ul
坓	fnl
坔	sl
坕	jl
坖	fwl
块	lzv
坘	ltlt
坙	tsl
坚	nal
坛	lfg
坜	ljj
坝	lbub
坞	lsst
坟	ldx
坠	pvl
坡	lja
坢	lvx
坣	wnl
坤	lbi
坥	lqf
坦	lbt
坧	lc
坨	lnt
坩	lhf
坪	ltvi
坫	lyod
坬	ljjn
坭	lpt
坮	lgo
坯	ljyt
坰	lno
坱	lny
坲	lzsn
坳	lwj
坴	lvl
坵	lg
坶	lqs
坷	lto
坸	lso
坹	lnv
坺	lxad
坻	lctd
坼	ljjd
坽	lvjd
坾	lnt
坿	ltxd
垀	ljvi
垁	lly
垂	jxhf
垂	jthl
垃	ldul
垄	xtdl
垅	lxtd
垆	lyp
垇	lu
垈	tvl
垉	lse
垊	lptv
型	thnl
垌	lnto
垍	ljg
垎	lao
垏	lef
垐	vrvl
垑	ldd
垒	gggl
垓	ldyv
垔	cl
垕	jjtl
垖	ljpz
垗	lvwv
垘	ltyd
垙	lww
垚	lll
垛	lwmd
垜	lzjm
垝	lrjc
垞	lnjt
垟	lvf
垠	lek
垡	txl
垢	ljjo
垣	ltbt
垤	ltgl
垥	lvto
垦	ekl
垧	ljno
垨	lnxd
垩	twtl
垪	lvh
垫	fxdl
垬	lhv
垭	ltwt
垮	lyfs
垯	lyz
垰	lltd
垱	lwe
垲	lezl
垳	lsfi
垴	ldxu
垵	lnr
垶	ldx
垷	lgw
垸	lnfw
垹	lfp
垺	ljz
垻	lgv
垼	swal
垽	sjjl
垾	lbf
垿	ljdt
埀	jtkl
埁	levj
埂	ltbx
埃	lgly
埄	laf
埅	pdhl
埆	lr
埇	ldnf
埇	lddi
埈	lgva
埉	lyvv
埉	ltvv
埊	esl
埋	lbl
埌	ldek
埍	lod
城	ljjx
埏	ljlz
埐	lena
埑	fjjl
埒	ljxd
埓	ljxd
埔	ltdd
埕	loe
埖	lhtt
埗	ly
埘	lbxd
埙	lob
埚	lonv
埛	lnvo
埜	mml
埝	lvju
埞	lntl
域	ltox
埠	ljpx
埡	ltxt
埢	lvyc
埣	ldvx
埤	lgjx
埥	lld
埦	lndc
埧	lqev
埨	lvth
埩	lrei
埪	lnvi
埫	lwno
埬	ltbm
埭	les
埮	lxx
埯	lybl
埰	ljm
埱	llma
埲	levf
埳	lrg
埴	lxqe
埵	ljxf
埵	ljtl
埶	lvld
執	lyxd
執	lvxd
埸	lbss
培	ldo
基	hevl
埻	ldoz
埼	lyto
埽	leni
埾	pal
埿	sptl
堀	lpue
堁	lbm
堂	wnol
堃	dhdl
堄	lgw
堅	gal
堆	lti
堇	hol
堈	lnve
堉	ldgd
堊	txtl
堋	ldd
堌	lqxo
堍	lrod
堎	llva
堏	mdhl
堐	ljll
堑	cjjl
堒	lbu
堓	lejf
堔	lnvm
堕	pxdl
堖	lsjx
堗	lnvd
堘	lvyl
堙	lcl
堚	lnc
堛	ltoq
堜	ltqm
堝	lqo
堞	lhlm
堟	lljx
堠	ltzy
堡	toml
堢	ltom
堣	lbng
堤	lbtl
堥	dtjl
堦	lug
堧	ljny
堨	lbsl
堩	lytt
堪	lhel
堫	lxua
堬	lvtn
堭	lge
堮	loos
堯	lllw
堰	lcbr
報	lypa
報	lvxa
堲	egpl
堳	ldjg
場	lbts
場	lbjs
堵	lyb
堶	lxid
堷	ldb
堸	lwjq
堹	ljtl
堺	lqvn
堻	sefl
堼	llxl
堽	lqtl
堾	levb
堿	ljtx
塀	lpvh
塁	qxl
塂	lhve
塃	lhdm
塄	lqdh
塅	ljia
塆	ldms
塇	lntt
塈	egcl
塉	lxvd
塊	lgwg
塋	xxnl
塌	lbjj
塍	dvyl
塎	lnvo
塏	letv
塐	llwm
塑	vujl
塒	lbld
塓	lnbv
塔	lhvo
塕	lvgj
塖	ljxv
塗	svtl
塘	ljeo
塙	ldoo
塚	lnxd
塛	lcm
塜	lnfx
塝	ldnh
塞	nfnl
塟	htdl
塠	ljpz
塡	ltgv
塢	ljzh
塣	soel
塤	logv
塥	ltoy
塦	pcl
塧	lvvq
塨	lhvd
塩	lloq
塪	ljg
填	lxqv
塬	ljgm
塭	lbq
塮	lrxd
塯	lgdq
塰	slql
塱	degl
塲	llbs
塳	lafz
塴	ledd
塵	jznl
塶	ljzu
塷	lyqd
塸	lcoo
塹	ccjl
塺	jmml
塻	lhby
塼	ltbd
塽	lyxx
塾	dozl
塿	lotr
墀	lpsi
墁	lbqa
墂	lcfm
境	ldbw
墄	ljlx
墅	bldl
墆	lhwi
墆	lhni
墇	ldbx
墈	lhej
墉	ljei
墊	lyxl
墊	lvxl
墋	lggs
墌	ljhh
墍	gtcl
墎	ldop
墏	kdxl
墐	lhol
墑	ldno
墒	ldno
墓	hbyl
墔	leti
墕	ltlh
墖	lvtq
増	lvqb
墘	lxbz
墙	lxvo
墚	lsdm
墛	lpfd
墜	pvxl
墝	lllw
增	lvqb
墟	lywt
墠	loox
墡	lvfo
墢	lxza
墣	lwtv
墤	oqgv
墥	ldbl
墦	ljxq
墧	ljyo
墨	qhl
墩	ldoa
墪	dozl
墫	lvud
墬	pljl
墭	ljjq
墮	pxil
墯	yxil
墰	lcbx
墱	lxtv
墲	llhh
墳	lxhv
墴	lhdv
墵	lufg
墶	llvz
墷	lhtf
墸	lhyb
墹	lnb
墺	ljny
墻	lxvo
墼	cuwl
墽	lgda
墾	jekl
墿	lqly
墿	lqlx
壀	lpox
壁	podl
壂	phvl
壃	ltqt
壄	mdtl
壅	dwjl
壆	jkxl
壇	ldqt
壈	ldqh
壉	lyx
壊	lxqk
壋	lwnq
壌	ldvk
壍	scjl
壎	ljth
壏	lgkq
壐	tvnl
壑	yntl
壒	lhlq
壓	jbdl
壔	lljd
壕	ldox
壖	lujn
壗	lelq
壗	leiq
壘	qqql
壙	ljhv
壚	lyqq
壛	lnrg
壜	lbug
壝	lqgz
壞	ldqk
壟	ddtl
壟	ddsl
壠	ldde
壡	yntl
壢	ljhl
壣	lpwh
壤	ldok
壥	ljql
壦	lhoi
壧	looa
壨	qqql
壩	luhd
壪	lwis
士	liis
壬	jlbr
壬	jlar
壭	lp
壮	kluz
壯	kl
声	ldj
壱	lnt
売	lnw
壳	lnw
壴	lov
壵	lll
壶	lnwt
壷	lnot
壸	lntt
壹	lntv
壺	lnxt
壻	ljld
壼	lntt
壽	ljid
壾	lovg
壿	lvud
夀	fjod
夁	lqqo
夂	aii
夃	zja
处	ay
夅	aci
夆	af
备	aq
夈	ax
変	dma
夋	gva
夌	lva
复	lba
夎	vvla
夏	jga
夐	rnva
夑	xixa
夒	tlja
夒	tjga
夒	jgla
夓	ejga
夔	vjga
夕	diix
夕	diis
外	dyuw
夗	dc
夘	dp
夙	wtd
多	ddbd
夛	ed
夜	dtdn
夝	djl
夞	dyot
够	sodd
夠	ddso
夡	ddlo
夢	hqnd
夣	dgqd
夤	dntv
夥	bmdd
夦	hevd
大	yiid
夨	ly
天	tybt
天	tyat
太	ydct
夫	fvaf
夬	zv
夭	jyby
央	ny
夯	yjbh
夰	yn
失	kv
夲	yx
夳	yf
头	ddy
夵	ym
夶	yy
夷	tzsv
夸	yfs
夹	tvv
夺	yxdd
夻	yo
夼	ym
夽	yfg
夾	yvv
夾	tvvv
夿	ydl
奀	jyy
奁	ycx
奂	rny
奃	yctd
奄	ybl
奅	ycjp
奆	yg
奇	yto
奈	yfm
奉	evf
奊	llly
奋	yqbf
奌	yoy
奍	vyn
奎	yll
奏	evty
奐	rnvy
契	fdy
奒	ydyv
奓	ydd
奔	yxh
奕	dmy
奖	kdy
套	ykbt
奘	kly
奙	gybl
奚	jwy
奛	ybd
奜	neey
奜	eney
奝	ynlo
奞	yti
奟	ydd
奠	vuy
奡	jgyn
奢	yyb
奣	tybd
奤	yjqf
奥	jnxy
奦	dtjy
奧	jnjy
奨	kjxy
奩	ycoo
奪	ytid
奫	yskk
奬	kdxy
奭	tjbv
奮	ytiq
奯	yljx
奰	qqqy
奱	wmiy
奲	yybx
女	riin
奴	ra
奵	rt
奶	rzj
奷	rjx
奸	rf
她	rcut
奺	rrn
奻	rr
奼	rjt
好	rz
奾	re
奿	xdr
妀	zlr
妁	rsd
如	ro
妃	rzl
妄	dlr
妅	ri
妆	kruz
妇	reuf
妈	rst
妉	rpl
妊	rjlr
妋	rfv
妌	rfn
妍	rthy
妎	rvn
妏	rdx
妐	rvg
妑	rdl
妒	rdp
妓	rxa
妔	rdw
妕	roi
妖	rjy
妗	rvj
妘	rfg
妙	rmj
妚	rjy
妛	ulr
妛	uitr
妜	rzv
妝	kr
妞	rjxt
妟	br
妠	rnv
妡	rjjt
妢	rvd
妣	ru
妤	rdt
妥	jr
妦	rf
妧	rfw
妨	rdh
妩	rfl
妪	rcxy
妫	rdjd
妬	rc
妭	rxad
妮	rpt
妯	rd
妰	rlk
妱	rdo
妲	rbt
妳	rrm
妴	dcr
妵	rde
妶	rdw
妷	rkv
妸	rto
妹	rfm
妺	rtm
妻	teir
妼	ruj
妽	rbi
妾	drbq
妾	drbc
妿	jor
姀	rh
姁	rso
姂	rjdz
姃	rtl
姄	rptv
姅	rvx
姆	rqs
姇	txdr
姈	rvjd
姉	rtni
姊	rsij
姊	rjsj
始	rgo
姌	rnl
姍	rnh
姎	rny
姏	rhf
姐	rqf
姑	rxo
姒	rldv
姓	rjlx
姓	rjls
委	hr
姕	ltr
姖	rg
姗	rnnt
姘	rvh
姙	rtjl
姚	rvwv
姛	rnto
姜	ver
姝	rkm
姞	rlo
姟	rdyv
姠	rjno
姡	rjxo
姢	rgd
姣	rdvx
姤	rjjo
姥	ryt
姦	rrr
姧	rrf
姨	rtzv
姩	rlci
姪	rtgl
姫	rg
姬	rguj
姭	jjjr
姮	rtbt
姯	rww
姰	rsb
姱	ryfs
姲	rnr
姳	rdo
姴	tdnr
姵	rwti
姶	rvto
姷	rxd
姸	rff
姹	rnjt
姺	rjlw
姻	rqy
姼	rdd
姽	rrjc
姾	rve
姿	vrvr
娀	rtxx
威	jtrx
娂	rhv
娃	rll
娄	xr
娅	rtwt
娆	rxtw
娇	rjyn
娈	dmr
娉	rdts
娊	rgw
娋	rwd
娌	rbll
娍	rjjx
娎	fjjr
娏	rxld
娐	rjz
娑	smjr
娒	rlqs
娓	rpjl
娔	rxow
娕	rtom
娖	rol
娗	rjlz
娘	rdek
娙	rtsi
娚	rqj
娛	rosy
娜	rdfp
娝	rjyo
娞	rjr
娟	rod
娠	rjfk
娡	rlu
娢	rvjo
娣	rvzj
娤	klr
娥	rjfx
娦	rgv
娧	rvow
娨	rbf
娩	rrow
娪	rwo
娫	rjlz
娬	rflv
娭	rgly
娮	ri
娯	rosv
娰	rtlv
娱	roty
娲	ronv
娳	rhn
娴	rnm
娵	rpa
娶	par
娷	rjxf
娷	rjtl
娸	rhev
娹	rzsw
娺	raaa
娻	rtbm
娼	rbb
娽	res
娾	rjll
娿	ptor
婀	rpto
婁	otor
婂	rgni
婃	rnfm
婄	rdo
婅	rsx
婆	sjar
婇	rjm
婈	rlva
婉	rndc
婊	rlk
婋	ryw
婌	rlma
婍	ryto
婎	rti
婏	rrod
婐	rbm
婑	rhr
婒	rxx
婓	neer
婓	ener
婔	rnee
婔	rene
婕	rtel
婖	rtyd
婗	rgw
婘	rvyc
婙	rrei
婚	rctb
婛	rdom
婜	gar
婝	rntl
婞	rly
婞	rlvx
婟	rqxo
婠	rnpz
婡	rxvv
婡	rtvm
婢	rgjx
婣	rktk
婤	rnlo
婥	rybx
婦	reni
婧	rld
婨	rvth
婩	rejf
婪	mmr
婫	rbu
婬	rjjl
婭	rtxt
婮	rpxo
婯	tndr
婰	ruv
婱	zsdr
婲	rhtt
婳	rtqu
婴	bbr
婵	rvbx
婶	rnbi
婷	rdot
婸	rbts
婸	rbjs
婹	rcr
婺	dtjr
婻	rxny
婻	rxnx
婼	rhxo
婽	rpfa
婾	rvtk
婿	rjld
媀	rbng
媁	rzii
媂	rdni
媃	rdtm
媄	rvey
媅	rhel
媆	rjny
媇	rdm
媈	rnc
媉	rptl
媊	rvdn
媋	revb
媌	rhq
媍	rrgv
媎	ryb
媏	rejn
媐	ger
媑	rjtl
媒	rhfm
媓	rge
媔	rjqf
媕	rvth
媖	rhny
媗	rntt
媘	rug
媙	rjtx
媚	rdjg
媛	rjfa
媜	rygv
媝	hxr
媞	rbtl
媟	rhlm
媠	rxid
媡	rtqm
媢	rnfg
媢	rbg
媣	rsxm
媤	rqu
媥	rdph
媦	rqd
媧	rqo
媨	rvu
媩	rxod
媪	rbq
媫	ryel
媬	rtom
媭	sjbr
媮	rvtn
媯	rdjh
媰	rsuj
媱	rjlu
媲	rjqu
媳	rjgu
媴	rlok
媵	dvyr
媶	rhp
媷	rjfd
媸	rulq
媸	ruiq
媹	rgdq
媺	reta
媻	nswr
媼	rqvq
媽	rsh
媾	rfnl
媿	rgwg
嫀	revh
嫁	rnx
嫂	rgia
嫃	rxqv
嫄	rjgm
嫅	rvfi
嫆	rnvo
嫇	rnbv
嫈	xxnr
嫉	rjly
嫊	rlwm
嫋	rzsv
嫌	rvem
嫍	rjg
嫎	rdnh
嫏	rdep
嫐	rqjr
嫑	jycr
嫒	rjna
嫓	rrnu
嫔	rngv
嫕	rclu
嫖	rcfm
嫗	rcoo
嫘	rqwm
嫙	rdhl
嫚	rbqa
嫛	clyr
嫜	rdbx
嫝	rjes
嫞	rjei
嫟	rcho
嫠	fmar
嫡	rdno
嫢	fvgr
嫣	rtlh
嫤	rhol
嫥	rtbd
嫦	rwni
嫧	rlgv
嫨	rhov
嫩	rtoa
嫪	rjjs
嫫	rhby
嫬	rjhh
嫭	ryji
嫮	rufs
嫯	lhar
嫰	rtov
嫱	rxvo
嫲	rjmm
嫳	vnmr
嫴	rxox
嫵	rlhh
嫶	rtih
嫷	rpxd
嫸	rvfo
嫹	rhdv
嫺	rnd
嫻	rnm
嫼	rqh
嫽	ryvm
嫾	rxdi
嫿	relt
嬀	rjjh
嬁	rxtv
嬂	rdbx
嬃	sjgr
嬄	rlnv
嬅	rhtf
嬆	rvtj
嬇	rqgv
嬈	rllw
嬉	rloo
嬊	hokr
嬊	hkor
嬋	roox
嬌	rjyo
嬍	reta
嬎	rrol
嬏	rjxq
嬐	rvtv
嬑	rdbu
嬒	rvtb
嬓	rgda
嬔	rrol
嬕	rqly
嬕	rqlx
嬖	podr
嬗	rdqt
嬘	rvxz
嬙	rxvo
嬚	rjvm
嬛	rqtk
嬜	dbrr
嬝	rgdk
嬞	rhjl
嬟	rvex
嬠	room
嬡	rjna
嬢	rdvk
嬣	rnut
嬤	rjmw
嬥	rjji
嬦	rljd
嬧	relq
嬧	reiq
嬨	rvwu
嬩	rjkv
嬪	rntv
嬫	rxxm
嬬	rujn
嬭	rtvx
嬮	jbdr
嬯	rlol
嬰	gvgr
嬱	scjr
嬲	qjrj
嬳	rhta
嬴	dlor
嬴	dlod
嬵	rwmi
嬶	rjgn
嬷	rjmg
嬸	rnjq
嬹	rjkv
嬺	rchu
嬻	rlqv
嬼	rgdn
嬽	rqiy
嬾	rtov
嬿	rhoh
嬿	rhkh
孀	rumg
孁	uoor
孂	rkeq
孃	rdok
孄	rntm
孅	rvvx
孆	rgvr
孇	rtia
孈	reto
孉	rhoi
孊	rjme
孋	rtnu
孌	wmir
孍	rooa
孎	rpsq
孏	rhnm
子	ziiz
孑	ziij
孒	jt
孓	jnaj
孔	zluk
孕	zjz
孖	zz
字	nz
存	xiz
孙	zm
孚	jzbf
孛	xnz
孜	za
孝	yzcx
孝	yzcs
孝	yzbx
孝	yzbs
孞	zu
孟	zqbm
孠	jtoz
孡	zgo
孢	zse
季	hzbj
孤	zjjn
孥	raz
学	wnz
孧	wjz
孨	zzz
孩	zdyv
孪	dmzl
孫	zjwm
孬	jyrz
孭	zgv
孮	znfm
孯	gaz
孰	dozd
孱	pzzz
孲	ztxt
孳	vwwz
孴	zzzb
孵	cypz
孶	dwdz
孷	fmaz
學	jkxz
孹	podz
孺	zujn
孻	zelq
孻	zeiq
孼	ujjz
孽	hjpz
孾	zgvr
孿	wmiz
宀	nii
宁	ntbn
宂	nw
它	nt
宄	nxbg
宅	njt
宆	nzs
宇	nfby
守	nxds
安	nr
宊	nyd
宋	nmbs
完	nfw
宍	ndv
宎	njy
宏	nxgh
宐	nhdt
宑	nfn
宒	njfl
宓	nuj
宔	nde
宕	ncbd
宖	nzsg
宗	nfm
官	npz
宙	ndbz
定	ntl
宛	ndc
宜	nqf
宝	ned
实	nddy
実	nev
宠	nxtd
审	nbi
客	naok
宣	ntbt
室	ntgl
宥	nxdy
宦	ng
宧	ng
宨	nvwv
宩	nx
宪	njlw
宫	noog
宬	njjx
宭	nejo
宮	nojo
宯	nyz
宰	ndxz
宱	ntlk
宲	nom
害	nfo
宴	nbr
宵	nwd
家	nxbj
宷	njx
宸	njfk
容	nvvo
宺	notm
宻	nave
宼	nfwr
宽	nhnw
宾	ngv
宿	ntjb
寀	njm
寁	ntel
寂	nlma
寃	nrod
寄	nyto
寅	ntdv
密	nuje
寇	nfwa
寈	nld
寉	nti
寊	nygv
寋	nfnc
富	ntoq
寍	nuq
寎	nktv
寏	nrny
寐	nkfm
寑	ntea
寒	nfnd
寓	nbng
寔	nbtl
寕	njqt
寖	nsea
寗	nujl
寘	nxqv
寙	njjn
寚	nelu
寛	nhgw
寜	nuqi
寝	nkea
寞	nhby
察	nxfm
寠	notr
寡	njqd
寢	nkea
寣	nki
寤	nkwo
寥	njjs
實	nqxv
寧	nuqt
寨	nfnm
審	njxq
寪	njjh
寫	ngsh
寬	nhgd
寭	ntbu
寮	nyvm
寯	ntim
寰	nqtk
寱	nkjm
寲	ntll
寳	nerv
寴	ndmw
寵	ndde
寶	nelv
寷	nffv
寸	xdcc
寸	xdac
对	axd
寺	lxd
寻	exdx
寻	exds
导	exdd
寽	jxd
対	dxxd
寿	fxds
尀	coxd
封	llxd
専	tdxd
専	tbid
尃	tdid
射	rxd
尅	xowd
将	kdxd
將	kdxd
專	tbgd
尉	pfmd
尊	vuxd
尋	eiod
尌	lovd
對	wtvd
導	vjgd
小	miix
小	miis
尐	mz
少	mjas
尒	vm
尓	lm
尔	rm
尕	zjm
尖	mybj
尗	lm
尘	mlbc
尙	mno
尚	wno
尛	mmm
尜	mym
尝	wnfg
尞	yvbm
尟	btlj
尠	hevj
尡	wwbu
尢	xlay
尣	vw
尤	xldy
尥	xlsd
尦	vwsd
尧	xtw
尨	xlsd
尩	vwe
尪	xle
尫	twe
尬	xlvn
尭	xhw
尮	xlzm
尯	xlrc
尰	xljl
就	domd
尲	xlvm
尳	xlqd
尴	xlnq
尵	xlqv
尶	twgq
尷	xlgq
尸	piis
尹	ejay
尺	pncc
尺	pnac
尻	pxck
尼	ptcn
尽	pndd
尾	pjfl
尿	pscn
局	pjo
屁	pucp
层	pfg
屃	pb
屄	pnv
居	pxo
屆	plu
屇	pq
屈	pue
屉	phl
届	pdcj
屋	ptgl
屌	poni
屍	ptdt
屎	pxcs
屏	pvh
屐	psxa
屑	pwd
屒	pjfk
屓	pgv
屔	gpt
展	phk
屖	pdx
屗	pjfd
屘	pjfz
屙	ppto
屚	pu
屛	pjff
屜	pshl
屝	pnee
屝	pene
属	pjog
屟	phlm
屠	pyb
屡	pxr
屢	potr
屣	psll
層	pvqb
履	psla
屦	psxr
屧	pshm
屨	psor
屩	psjo
屪	pnym
屫	pkjo
屬	psqq
屭	pgvv
屮	ui
屯	tul
屰	vuj
山	eiis
屲	je
屳	jne
屴	ej
屵	ej
屶	ed
屷	ezj
屸	ei
屹	elz
屺	ezlq
屻	edd
屼	etw
屽	ef
屾	ee
屿	esuy
岁	edbs
岂	ezlc
岃	edd
岄	ed
岅	ejja
岆	ejy
岇	ecp
岈	ecij
岉	ess
岊	dle
岋	ejzn
岌	ejzn
岍	eth
岎	evd
岏	efw
岐	exa
岑	evj
岒	evj
岓	ejjt
岔	vde
岕	evn
岖	ecx
岗	enx
岘	enwx
岙	jye
岚	ewx
岛	gecd
岜	edl
岝	elk
岞	elk
岟	eny
岠	eg
岡	nve
岢	eto
岣	eso
岤	env
岥	eja
岦	ed
岧	edo
岨	eqf
岩	ec
岪	ezsn
岫	edux
岫	edus
岬	eq
岭	evjd
岮	ent
岯	ejyt
岰	ewj
岱	tve
岲	eow
岳	geby
岴	eg
岵	exo
岶	eg
岷	eptv
岸	ejf
岹	edo
岺	evjd
岻	ectd
岼	etvi
岽	etm
岾	eyo
岿	ene
峀	ed
峁	ecjp
峂	eadd
峃	wne
峄	eafy
峅	egh
峆	evto
峇	evto
峈	eao
峉	eao
峊	jpze
峋	esb
峌	etgl
峍	eef
峎	eek
峏	ejnn
峐	edyv
峑	eve
峒	ento
峓	etzv
峔	eyt
峕	edb
峖	enr
峗	erjc
峘	etbt
峙	elxd
峚	eyl
峛	etdn
峜	evl
峝	ento
峞	erjc
峟	exd
峠	eltd
峡	etvv
峢	etdn
峣	extw
峤	ejyn
峥	erei
峦	dme
峧	edvx
峨	ejfx
峩	ejfx
峪	evvo
峫	ecip
峬	etdd
峭	ewdq
峮	eejo
峯	eaf
峰	eaff
峱	xjje
峲	ehn
峳	etia
峴	egw
峵	enxg
島	ge
峷	edx
峸	ejjx
峹	vtme
峺	etbx
峻	egva
峼	ejlo
峽	eyvv
峽	etvv
峾	sjje
峿	ewo
崀	edek
崁	elrv
崂	ehnj
崃	etx
崄	evtw
崅	er
崆	envi
崇	enfm
崈	nfme
崉	esb
崊	emm
崋	ethf
崌	epxo
崍	exvv
崍	etvm
崎	eyto
崏	ectb
崐	ebu
崑	ebu
崒	edvx
崓	eqxo
崔	eti
崕	ejll
崖	ejll
崗	enve
崘	evth
崙	evth
崚	elva
崛	epue
崜	ejxf
崜	ejtl
崝	eld
崞	edoz
崟	ev
崠	etbm
崡	ejxu
崢	ejei
崣	ehr
崤	exxd
崥	egjx
崦	eybl
崧	emvg
崨	etel
崩	edd
崪	edvx
崫	epue
崬	etbm
崭	ecjt
崮	eqxo
崯	ev
崰	esq
崱	egvn
崲	ege
崳	evtn
崴	ejtx
崵	ebts
崵	ebjs
崶	elld
崷	evu
崸	ejgv
崹	edni
崺	edhc
崻	esld
崼	ebtl
崽	equ
崾	ecr
崿	eoos
嵀	emde
嵁	ehel
嵂	esef
嵃	edjs
嵄	evey
嵅	ejtx
嵆	hxle
嵇	hxle
嵈	ejfa
嵉	edot
嵊	ejxv
嵋	edjg
嵌	ehfv
嵍	dtje
嵎	ebng
嵏	exua
嵐	ewjq
嵑	ebsl
嵒	oooe
嵓	eooo
嵔	eqtk
嵕	exua
嵖	embt
嵗	ejtx
嵘	ehnm
嵙	ehdx
嵚	evrv
嵛	evtn
嵜	edto
嵜	edoi
嵝	exr
嵞	vtme
嵟	ejti
嵠	ejwy
嵡	evgj
嵢	evdo
嵣	ejeo
嵤	xxne
嵥	edcm
嵦	eetv
嵧	egdq
嵨	ejzh
嵩	edoo
嵪	edoo
嵫	evww
嵬	egwg
嵭	ednh
嵮	exqv
嵯	evfi
嵰	evem
嵱	envo
嵲	ejgm
嵳	evfi
嵴	exvd
嵵	ebld
嵶	ezsv
嵷	esvl
嵸	esvl
嵹	ezsq
嵺	ejjs
嵻	ejes
嵼	edjl
嵽	ehwi
嵽	ehni
嵾	eggs
嵿	etjv
嶀	eufs
嶁	eotr
嶂	edbx
嶃	ecjt
嶄	ecjt
嶅	lhae
嶆	eub
嶇	ecoo
嶈	ekdd
嶉	eoti
嶊	efti
嶋	egh
嶌	egh
嶍	ejjg
嶎	epfd
嶏	ejul
嶐	epal
嶑	erox
嶑	erbx
嶒	evqb
嶓	ejxq
嶔	evrv
嶕	etih
嶖	evtj
嶗	exxj
嶘	emxx
嶙	exdi
嶚	eyvm
嶛	eyvm
嶜	ecwb
嶝	extv
嶞	pxie
嶟	evud
嶠	ejyo
嶡	ejvv
嶢	ellw
嶣	etih
嶤	ellw
嶥	ejvv
嶦	erji
嶧	eqly
嶧	eqlx
嶨	jkxe
嶩	eujk
嶪	ewtm
嶫	ewtm
嶬	evex
嶭	ejpx
嶮	evtv
嶯	eopx
嶰	erdi
嶱	ehbl
嶲	etim
嶳	exll
嶴	jnxe
嶵	eqne
嶵	eqee
嶶	esea
嶷	etll
嶸	exxm
嶹	eljd
嶺	evjv
嶻	eltx
嶼	ejkv
嶽	exjd
嶾	ejiu
嶿	eujn
巀	emjx
巁	ejhg
巂	etio
巃	edde
巄	edde
巅	exqb
巆	exxo
巇	eytx
巈	ehpx
巉	erod
巊	egvr
巋	ejpi
巌	ewja
巍	ehrg
巎	etja
巎	ejga
巏	ehoi
巐	edoh
巑	ejlv
巒	wmie
巓	etgv
巔	exqv
巕	evjr
巖	eooa
巗	eooa
巘	eytd
巙	evla
巙	evja
巚	eytd
巛	sii
川	miic
州	yyy
巟	dlm
巠	tsi
巡	szcx
巢	sbm
巣	wbm
巤	sqxv
工	iiig
左	xicz
左	xiaz
巧	its
巨	giij
巩	iwdg
巪	gj
巫	ivv
巬	iwfv
巭	ijfv
差	vfi
巯	zidm
巰	tsim
己	zlaj
已	eiiy
巳	eii
巴	dlab
巵	jjtl
巶	doe
巷	hvex
巷	hves
巸	ge
巹	jxtl
巺	eetv
巻	vyzl
巼	dlot
巽	eehv
巾	niaj
巿	tni
帀	tni
币	jni
市	dni
布	xni
帄	nit
帅	nnis
帆	niwd
帇	eni
师	ntni
帉	nivd
帊	nidl
帋	ctvi
希	xxni
帍	dpni
帎	nipl
帏	nifi
帐	nik
帑	rani
帒	tvni
帓	nitm
帔	nija
帕	nig
帖	niyo
帗	nixd
帘	nvni
帙	nikv
帚	enni
帛	gni
帜	niov
帝	dnni
帞	nijb
帟	dmni
帠	gni
帡	nivh
帢	nivo
帣	vyni
帤	roni
帥	jpzi
带	hnni
帧	niyb
帨	nivw
帩	niwd
帪	nijk
師	jpzi
帬	ejoi
席	jhni
帮	fpni
帯	teni
帯	hnni
帰	yeni
帰	neni
帱	nifd
帲	nijf
帳	nik
帴	nixx
帵	ninc
帶	hwni
帶	hnni
帷	niti
常	wnoi
帹	nidr
帺	nihv
帻	nilb
帼	niqd
帽	ning
帽	nibg
帾	niyb
帿	nity
幀	niyv
幁	nijv
幂	nbyi
幃	nizi
幄	nipl
幅	nitq
幆	nibl
幇	llxi
幈	niph
幉	nihm
幊	niiv
幋	nswi
幌	nibw
幍	nijg
幎	ninv
幏	ninx
幐	dvyi
幑	seja
幒	niju
幓	nigs
幔	niba
幕	hbyi
幖	nicm
幗	niqx
幘	nilv
幙	nihy
幚	fpgi
幛	nidx
幜	nibm
幝	niox
幞	niwv
幟	nidx
幠	nilh
幡	nijq
幢	nidl
幣	vnmi
幤	wnoi
幥	niwf
幦	podi
幧	niom
幨	niri
幩	nixv
幪	nihx
幫	llxi
幬	nild
幭	nihx
幮	nijd
幯	nikp
幰	ninu
幱	ninm
干	fiig
平	tvi
年	lci
并	vh
幷	jfjf
幸	lybx
幸	lvx
幹	xbxf
幺	wiiy
幻	wjuh
幼	wjuy
幽	wwe
幾	wwyx
广	jiig
庀	jtcp
庁	jt
庂	jv
広	jg
庄	jlcz
庅	jjg
庆	jycq
庆	jycc
庇	ju
庈	jvj
庉	jtul
床	jmcc
庋	jxa
庌	jcij
庍	jjjt
庎	jvn
序	jdt
庐	jdp
庑	jfl
庒	jld
库	jcck
应	jwcy
底	jctd
庖	jse
店	jyod
庘	jq
庙	jd
庚	jev
庛	jlt
府	jtxd
庝	jadd
庞	jxtd
废	jyad
庠	jvfx
庡	jdk
庢	jtgl
庣	jvwv
庤	jlxd
庥	jtm
度	jha
座	jvvl
庨	jyz
庩	jvtm
庪	jfxa
庫	jc
庬	jxld
庭	jjlz
庮	ju
庯	jtdd
庰	jvh
庱	jlva
庲	jxvv
庲	jtvm
庳	jgjx
庴	jhb
庵	jybl
庶	jhh
康	jes
庸	jedi
庹	jhpn
庺	jvgm
庻	jhvv
庼	jtlb
庽	jbng
庾	jgv
庿	jhq
廀	jnxa
廁	jgvn
廂	jmg
廃	jxtl
廃	jxth
廄	jega
廅	jlgq
廆	jgwg
廇	jgdq
廈	jjga
廉	jvem
廊	jdep
廋	jgia
廌	jznh
廍	jdop
廎	jtlv
廏	jgta
廐	jgtw
廑	jhol
廒	jlha
廓	jdop
廔	jotr
廕	jpvg
廖	jjjs
廗	jhwi
廗	jhni
廘	jjzu
廙	jqhv
廚	jlod
廛	jbll
廜	jpyb
廝	jhet
廞	jvrv
廟	jxbd
廠	jwna
廡	jlhh
廢	jxza
廣	jhdv
廤	jcot
廥	jvtb
廦	jpox
廧	jxvo
廨	jrdi
廩	jdqh
廪	jdqm
廫	jdjs
廬	jyqq
廭	jhlv
廮	jgvr
廯	jrhf
廰	jpxu
廱	jsoi
廲	jtnu
廳	jpeu
廴	zii
廵	sz
延	jlzy
廷	jlzt
廸	dz
廹	gz
建	efz
廻	qoz
廼	cz
廽	qnfz
廾	hii
廿	hiiy
开	thbk
开	thak
弁	ghbb
异	ehby
弃	dgh
弄	ehbn
弅	vdh
弆	lgh
弇	vtoh
弈	dmh
弉	klh
弊	vnmh
弋	viiy
弌	ttv
弍	tfv
弎	tev
式	tiv
弐	ffv
弑	xmtv
弒	xmdv
弓	zsbg
弓	zsag
弔	zsi
引	zsi
弖	zst
弗	zsn
弘	zsg
弙	zsf
弚	vzsi
弛	zsc
弜	zszs
弝	zsdl
弞	zsrv
弟	vzsj
张	zsk
弡	zsg
弢	zsua
弣	zstd
弤	zscd
弥	zsrm
弦	zsdw
弧	zsjn
弨	zsdo
弩	razs
弪	zszi
弫	zsg
弬	zsg
弭	zsp
弮	vyzs
弯	dmzs
弰	zswd
弱	zsvv
弲	zsod
弳	zsti
弴	zsdz
張	zsk
弶	zsdm
強	zsgq
弸	zsdd
弹	zsvx
强	zsoq
弻	zsts
弼	zsjs
弽	zshm
弾	zswx
弿	nfns
彀	lnta
彁	zsto
彂	wtzy
彃	zsbf
彄	zsco
彅	zsvd
彆	wnms
彇	zsek
彈	zsox
彉	zshv
彊	zstt
彋	zsqk
彌	zstx
彍	zsjv
彎	wmis
彏	zsga
彐	eii
彑	ljt
归	neug
当	we
彔	ljts
录	esbl
彖	ljx
彗	ffe
彘	ljtt
彙	ljtm
彚	enbm
彛	exvh
彜	ljth
彝	ljth
彞	exwh
彟	exda
彠	eioa
彡	sii
形	ths
彣	dxs
彤	nds
彥	dxjs
彦	djs
彧	totd
彨	tnds
彩	jms
彪	yws
彫	nlos
彬	mms
彭	lovs
彮	nvvs
彯	cfms
彰	dbxs
影	bdos
彲	tnds
彳	sii
彴	ssd
彵	sc
彶	sjzn
彷	sdhp
彸	svg
役	sway
彺	se
彻	stdc
彼	sjab
彽	sctd
彾	svjd
彿	szsn
往	sdew
征	stl
徂	sqf
徃	sjl
径	szij
待	slxd
徆	sc
徇	ssbs
很	sek
徉	svf
徊	sqo
律	sefl
後	swah
徍	sll
徎	soe
徏	sy
徐	svtm
徑	stsi
徒	sllt
従	svl
徔	shdz
徕	stx
徖	snfm
得	sbtd
徘	sene
徙	sllx
徚	stqm
徛	syto
徜	swno
徝	sxqe
從	svvl
徟	snlo
徠	sxvv
徠	stvm
御	slxp
御	sklp
徢	stel
徣	shb
徤	sefz
徥	sbtl
徦	spfa
徧	sdph
徨	sgeh
復	slba
循	sjjg
徫	szii
徬	sdnh
徭	sjlu
微	sewa
微	seta
徯	sjwy
徰	stll
徱	scfm
徲	spsi
徳	sxqu
徴	seea
徵	seta
徶	svna
德	sxqu
徸	sdbl
徹	sdga
徺	sllw
徻	svtb
徼	sgda
徽	seta
徽	sema
徾	seia
徿	sdde
忀	sdok
忁	sbus
忂	sggi
心	uiix
心	uiis
忄	yii
必	uj
忆	yzuy
忇	yj
忈	fu
忉	ydud
忊	yt
忋	yzl
忌	zlu
忍	ddu
忎	jxu
忏	yjx
忐	lubt
忑	tdu
忒	tuv
忓	yf
忔	ylz
忕	yy
忖	yxdc
志	lubz
忘	dlu
忙	ydl
忚	yc
忛	ywd
応	ju
忝	tymd
忞	dxu
忟	ydx
忠	oiu
忡	yoi
忢	wu
忣	yjzn
忤	ylx
忥	kzu
忦	yvn
忧	yxld
忨	yfw
忩	vgu
忪	yvg
快	yzv
忬	ydt
忭	ydy
忮	yxa
忯	yctv
忰	yxx
忱	ypl
忲	yyd
忳	ytul
忴	yvj
念	vju
忶	yfg
忷	yxu
忸	yjxt
忹	ye
忺	yrv
忻	yjjt
忼	ydw
忽	ssu
忾	ykz
忿	vdu
怀	yjy
态	ydu
怂	vvu
怃	yfl
怄	ycx
怅	ykuc
怆	yvc
怇	yg
怈	yhl
怉	yse
怊	ydo
怋	yptv
怌	yjyt
怍	ylk
怎	lku
怏	yny
怐	yso
怑	yvx
怒	rau
怓	yra
怔	ytl
怕	ygup
怖	yxni
怗	yyo
怘	xou
怙	yxo
怚	yqf
怛	ybt
怜	yvjd
思	qubs
怞	yd
怟	yctd
怠	gou
怡	ygo
怢	ykv
怣	kvu
怤	txdu
急	reu
怦	ytvi
性	yjl
怨	dcu
怩	ypt
怪	yal
怫	yzsn
怬	yq
怭	yuj
怮	ywj
怯	ylg
怰	ydw
怱	ssdu
怲	ytnv
怳	yow
怴	ycx
怵	ymd
怶	yja
怷	xwdu
怸	mdu
怹	tcu
怺	ydjx
总	vou
怼	axdu
怽	yfm
怾	yov
怿	yaf
恀	ydd
恁	tjlu
恂	ysb
恃	ylxd
恄	ylo
恅	yyt
恆	ytht
恇	yce
恈	ygki
恉	ytb
恊	yjjj
恋	dmu
恌	yvwv
恍	yww
恎	ytgl
恏	rzu
恐	iwdu
恑	yrjc
恒	ytbt
恓	yc
恔	ydvx
恕	rou
恖	jqxu
恗	yyfs
恘	ytm
恙	veu
恚	llu
恛	yqo
恜	ytiv
恝	fdu
恞	ytzv
恟	ysxu
恠	yxil
恡	yxxg
恢	yxx
恣	vrvu
恤	yjq
恥	pu
恦	yjno
恧	jnnu
恨	yek
恩	qyu
恪	yao
恫	ynto
恬	yjxo
恭	hvmd
恮	yve
息	jgu
恰	yvto
恱	yvgw
恲	yvh
恳	eku
恴	dbu
恵	tdu
恵	tbiu
恶	twtu
恷	tmu
恸	yfgj
恹	yjyd
恺	yezl
恻	ybn
恼	ydxu
恽	ync
恾	yhdl
恿	dnfu
恿	ddiu
悀	ydnf
悀	yddi
悁	yod
悂	yul
悃	yqm
悄	ywd
悅	yvow
悆	vtmu
悇	yvtm
悈	ythx
悉	jxux
悉	jxus
悊	fjju
悋	ydxo
悌	yvzj
悍	ybf
悎	yjlo
悏	yyvv
悏	ytvv
悐	xjxu
悑	ytdd
悒	yodl
悓	ygw
悔	ylqs
悕	yxxi
悖	yxnz
悗	yrow
悘	clyu
悙	ydoj
悚	ytom
悛	ygva
悜	yoe
悝	ybl
悞	yosy
悟	ywo
悠	tiau
悡	hnu
悢	ydek
患	ooiu
悤	jqdu
悥	iu
悦	yvow
悧	yhn
您	trmu
悩	ywxu
悪	tonu
悫	lnwu
悬	qfgu
悭	ynal
悮	yoty
悯	yndx
悰	ynfm
悱	yene
悲	neeu
悲	eneu
悳	xneu
悴	ydvx
悵	yk
悶	nnu
悷	ydpd
悸	yhz
悹	npzu
悺	ynpz
悻	yly
悻	ylvx
悼	yybx
悽	yter
悾	ynvi
悿	ytyd
惀	yvth
惁	mjju
惂	yrg
惃	ybu
惄	lmau
情	yld
惆	ynlo
惈	ybm
惉	syou
惊	ydom
惋	yndc
惌	ndcu
惍	yv
惎	hevu
惏	ymm
惐	ytox
惑	totu
惒	hou
惓	yvyc
惔	yxx
惕	ybss
惖	bssu
惗	yvju
惘	ynvl
惙	yaaa
惚	yssu
惛	yctb
惜	yhb
惝	ywno
惞	yjjv
惟	yti
惠	tbgu
惡	txtu
惢	uuu
惣	jfsu
惤	yzsw
惥	gvu
惦	yjyo
惧	yqev
惨	ygys
惩	stlu
惪	xqeu
惫	aqu
惬	yctv
惭	ycjt
惮	yvbx
惯	yqxb
惰	yxid
惱	ysjx
惲	ync
想	mgu
惴	yejn
惵	yhlm
惶	yge
惷	evbu
惸	ysbz
惹	hxou
惺	ybjl
惻	ygvn
惼	ydph
惽	yptb
惾	yxua
惿	ybtl
愀	yhx
愁	hxu
愂	xnzu
愃	yntt
愄	yqtk
愅	yhp
愆	ssfu
愇	yzii
愈	vtdu
愉	yvtn
愊	ytoq
愋	yjfa
愌	yrny
愍	ptvu
愎	ylba
意	dbu
愐	yjqf
愑	ydnj
愑	yddj
愒	ybsl
愓	ybts
愓	ybjs
愔	ydb
愕	yoos
愖	yhel
愗	dtju
愘	ynao
愙	naou
愚	bngu
愛	jnua
愜	yctv
愝	ycbr
愞	yjny
感	jtou
愠	ybq
愡	yssu
愢	yqu
愣	yqdh
愤	yxhb
愥	yhny
愦	yqb
愧	ygwg
愨	lntu
愩	yigv
愪	yogv
愫	ylwm
愬	vuju
愭	yytb
愮	yjlu
愯	ytia
愰	ybww
愱	yjly
愲	yqd
愳	ggu
愴	yvdo
愵	yzsv
愶	yjjd
愷	yetv
愸	xvvu
愸	tvvu
愹	ynvo
愺	yhbx
愻	zjwu
愼	ytgv
愽	ytdd
愾	ykzx
愿	jgmu
慀	yjwy
慁	qxu
慂	sdnu
慂	sddu
慃	yvgj
慄	ycm
慅	yadq
慆	yjg
慇	jjeu
慈	vwwu
慉	ydwq
慊	yvem
態	gdtu
慌	yhdm
慍	yqvq
慎	yxqv
慏	ynbv
慐	igvu
慑	ypaa
慒	yub
慓	ycfm
慔	yhby
慕	hbyd
慖	yqtx
慗	tomu
慘	yggs
慙	ccju
慚	ycjt
慛	yeti
慜	lqsu
慝	chxu
慞	ydbx
慟	yjtj
慠	ylha
慡	yyxx
慡	ytxv
慢	ybqa
慣	yqxv
慤	lnwu
慥	yjlz
慦	xxdu
慧	ffeu
慨	yegw
慩	ycz
慪	ycoo
慫	svvu
慬	yhol
慭	txyu
慮	ytqu
慯	ylbs
慰	pfmu
慱	ytbd
慲	yhnd
慳	ygal
慴	yjjg
慵	yjei
慶	jzna
慷	yjes
慸	hnnu
慹	lyxu
慹	lvxu
慺	yotr
慻	yvyg
慼	jlmu
慽	yjlx
慾	vvou
慿	vshu
憀	yjjs
憁	yjqu
憂	jqfa
憂	jnfa
憃	evgu
憄	sxgu
憅	jtbu
憆	ywnl
憇	jxou
憈	yywt
憉	ylos
憊	thju
憋	vnmu
憌	vvsu
憍	yjyo
憎	yvqb
憏	yxfm
憐	yxdi
憑	vshu
憒	yqgv
憓	ytbu
憔	ytih
憕	yxtv
憖	xvvu
憖	tvvu
憗	xvvu
憗	tvvu
憘	yloo
憙	lovu
憚	yoox
憛	ycbx
憜	ypxd
憝	dozu
憞	ydoa
憟	ycx
憠	jvuu
憡	yktm
憢	yllw
憣	yjxq
憤	yxhv
憥	xxnu
憦	yxxj
憧	ydbl
憨	jpau
憩	jxou
憪	ynd
憫	yndx
憬	ybdm
憭	yyvm
憮	ylhh
憯	ycwb
憰	ydto
憱	ydod
憲	nlqu
憳	yeid
憴	yq
憵	podu
憶	ydbu
憷	ymml
憸	yvtv
憹	yujk
憺	yrji
憻	ydqt
憼	hsou
憽	yhsu
憾	yjtu
憿	ygda
懀	yvtb
懁	yqtk
懂	yhjl
懃	holu
懄	yhoj
懅	yyx
懆	yoom
懇	jeku
懈	yrdi
應	jttu
懊	yjny
懋	mdtu
懌	yqly
懌	yqlx
懍	ydqh
懎	yxvo
懏	ytim
懐	ydqk
懑	shtu
懒	ytob
懓	yjna
懔	ydqm
懕	jbdu
懖	vvju
懗	ylmm
懘	shnu
懙	yjkv
懚	yjiu
懛	ylol
懜	yhqd
懝	ytll
懞	yhnx
懟	wtvu
懠	yddh
懡	yjmg
懢	ygkq
懣	shnu
懤	yljd
懥	yxnl
懦	yujn
懧	ynut
懨	yjbd
懩	yvek
懪	ybhs
懫	yjjv
懬	jhdu
懭	yjhv
懮	yjqa
懮	yjna
懯	tdiu
懰	ygdn
懱	yhqx
懲	setu
懳	yffu
懴	ylnx
懴	ylex
懵	yhqg
懶	ytov
懷	ydqk
懸	qemu
懹	ydok
懺	yvvx
懻	yktv
懼	yggi
懽	yhoi
懾	yppp
懿	lntu
戀	wmiu
戁	hofu
戂	yjme
戃	ywnh
戄	ygga
戅	dbxu
戆	dbxu
戇	dbxu
戈	xiig
戉	cx
戊	jxaw
戋	fxaj
戌	jtx
戍	jdx
戎	txx
戏	axux
成	jjx
我	jfxw
戒	thx
戓	tox
戔	xx
戕	kx
或	totx
戗	vcx
战	yox
戙	ntox
戚	jlmx
戛	jgx
戜	toex
戝	gvx
戞	jqfx
戞	jnfx
戟	xbxx
戠	dbx
戡	hevx
戢	opx
戣	xtyx
戤	zjax
戥	bjlx
戦	wbxx
戧	vdex
戨	totx
戩	tggx
截	ltix
戫	xdtx
戬	twtx
戭	ntdx
戮	jjvx
戯	ywtx
戰	oobx
戱	ywtx
戲	ytox
戳	jjtx
戴	lqhx
戵	ggtx
戶	jjz
户	dpbh
戸	tp
戹	dpz
戺	dpe
戻	dpy
戼	jctz
戽	dpdx
戾	dpyd
房	dpdh
所	jjzt
扁	dpnh
扂	dpyo
扃	dpno
扄	dpjo
扅	dpdd
扆	dpdk
扇	dpjj
扈	dpol
扉	dpee
扊	dpxx
手	jfas
扌	fii
才	xjac
扎	fluz
扏	fx
扐	fj
扑	fyup
扒	fv
打	ft
扔	fzj
払	fg
扖	fjn
扗	fl
托	fjt
扙	fxn
扚	fsd
扛	fiuk
扜	ff
扝	ffs
扞	ff
扟	fzx
扠	fad
扡	fc
扢	flz
扣	fo
扤	ftw
扥	fjt
扦	fjx
执	fxd
扨	fdd
扩	fjuk
扪	fnum
扫	feus
扬	fzs
扭	fjxt
扮	fvd
扯	fluc
扰	fxld
扱	fjzn
扲	fvj
扳	fjja
扴	fvn
扵	fvdd
扶	ffv
扷	fjy
扸	fk
批	fuup
扺	fctv
扻	frv
扼	fjc
扽	ftul
找	fxuz
承	jex
技	fxa
抁	fgw
抂	fe
抃	fdy
抄	fmj
抅	fsg
抆	fdx
抇	fb
抈	fd
抉	fzv
把	fdl
抋	fu
抌	fpl
抍	fjh
抎	ffg
抏	ffw
抐	fnv
抑	fcp
抒	fdt
抓	fjuz
抔	fjy
投	fwa
抖	fddx
抗	fdw
折	fjjt
抙	fjf
抚	ffl
抛	fxj
抜	fxa
抝	fwj
択	fpn
抟	ffsd
抠	fcx
抡	fvt
抢	fvc
抣	fsv
护	fdp
报	fpab
抦	ftnv
抧	fov
抨	ftvi
抩	fnl
抪	fxni
披	fja
抬	fgo
抭	fnw
抮	fvs
抯	fqf
抰	fny
抱	fse
抲	fto
抳	fpt
抴	fhl
抵	fctd
抶	fkv
抷	fjyt
抸	fjdz
抹	ftm
抺	ffm
抻	fbi
押	fquy
抽	fduc
抾	flg
抿	fptv
拀	fow
拁	fjo
拂	fzsn
拃	flk
拄	fde
担	fbt
拆	fjjd
拇	fqs
拈	fyo
拉	fdul
拊	ftxd
拋	fxlj
拌	fvx
拍	fgup
拎	fvjd
拏	rajf
拐	foj
拑	fhf
拒	fguz
拒	fguj
拓	fcut
拔	fxad
拕	fnt
拖	flc
拗	fwj
拘	fso
拙	fue
拚	fgh
招	fdoz
拜	jff
拝	ff
拞	fg
拟	fldv
拠	faw
拡	fjg
拢	fxtd
拣	ftjv
拤	fly
拥	fnf
拥	fdi
拦	fvel
拧	fnt
拨	fyad
择	faf
拪	fc
拫	fek
括	fjxo
拭	ftiv
拮	flo
拯	fjxt
拰	ftjl
拱	fhv
拲	hvjf
拳	vyjf
拴	fves
拵	fxiz
拶	fsd
拷	fys
拸	fdd
拹	fjjj
拺	ftnm
拻	fxx
拼	fvh
拽	fbx
拾	fvto
拿	vtof
挀	fjjk
持	flxd
挂	fll
挃	ftgl
挄	fww
挅	fzjm
挆	fwm
指	ftb
挈	fdjf
按	fnr
挊	fltd
挋	fg
挌	fao
挍	fdvx
挎	fyfs
挏	fnto
挐	rojf
挑	fvwv
挒	ftdn
挓	fnjt
挔	fdk
挕	fp
挖	fnvz
挗	ftzv
挘	fmjj
挙	wvjf
挚	fxdf
挛	dmjf
挜	ftwt
挝	fxdz
挞	fyz
挟	ftvv
挠	fxtw
挡	fwe
挢	fjyn
挣	frei
挤	fdxn
挥	fnc
挦	fexd
挧	fjj
挨	fgly
挩	fvow
挪	fdfp
挫	fvvl
挬	fxnz
挭	ftbx
挮	fvzj
振	fjfk
挰	foe
挱	fsmj
挲	smjf
挳	ftsi
挴	flqs
挵	feh
挶	fpjo
挷	ffp
挸	fgw
挹	fodl
挺	fjlz
挻	fjlz
挼	fjr
挽	frow
挾	fyvv
挾	ftvv
挿	fjti
捀	faf
捁	fjlo
捂	fwo
捃	fejo
捄	fxxd
捅	fdnf
捅	fddi
捆	fqm
捇	flm
捈	fvtm
捉	fol
捊	fjz
捋	fjxd
捌	fojn
捍	fbf
捎	fwd
捏	fbl
捐	fod
捑	fbly
捒	ftom
捓	fcip
捔	fr
捕	ftdd
捖	fnfw
捗	fy
捘	fgva
捙	fc
捚	fbl
捛	foo
捜	fbia
捝	fvow
捞	fhnj
损	fob
捠	fgv
捡	fvtw
换	frny
捣	fge
捤	fpjl
捥	fndc
捦	fv
捧	fevf
捨	fvfo
捩	fdpd
捪	fctb
捫	fn
捬	fjtd
捭	fgjx
据	fpxo
捯	ftgn
捰	fbm
捱	fjll
捲	fvyc
捳	fge
捴	fvgu
捵	fuv
捶	fjxf
捷	ftel
捸	fes
捹	fyxh
捺	fyfm
捻	fvju
捼	fhr
捽	fdvx
捾	fnpz
捿	fter
掀	fjjv
掁	fk
掂	fjyo
掃	feni
掄	fvth
掅	fld
掆	fnve
掇	faaa
授	fjna
掉	fybx
掊	fdop
掋	fjcd
掌	wnof
掍	fbu
掎	fyto
掏	fslu
掐	frg
掑	fhev
排	fene
掓	flma
掔	gajf
掕	flva
掖	fdtn
掗	ftxt
掘	fpue
掙	fjei
掚	ftnd
掛	flly
掜	fgw
掝	ftox
掞	fxx
掟	fntl
掠	fdom
採	fjm
探	fnvm
掣	knif
掤	fdd
接	fdr
掦	fbss
控	fnvi
推	fti
掩	fybl
措	fhb
掫	fpa
掬	fsx
掭	ftyd
掮	fdpd
掯	fld
掰	jfvf
掱	jfjf
掲	fbst
掳	fyj
掴	fqed
掵	fvtp
掶	fjev
掷	fvyp
掸	fvbx
掹	fzq
掺	fgys
掻	faq
掼	fqxb
掽	fvwt
掾	fljx
掿	fhxo
揀	ftqm
揁	fygv
揂	fvu
揃	fvdn
揄	fvtn
揅	cthf
揆	fxty
揇	fxny
揇	fxnx
揈	fsi
揉	fdtm
揊	ftoq
揋	fqtk
揌	fqu
揍	fevy
揎	fntt
描	fhq
提	fbtl
揑	fgi
插	fjxg
揓	fdhc
揔	fssu
揕	fhel
揖	fop
揗	fjjg
揘	fge
揙	fdph
揚	fbts
揚	fbjs
換	frny
揜	fvth
揝	fayb
揞	fdb
揟	fjld
揠	fcbr
握	fptl
揢	fnao
揣	fejn
揤	fegp
揥	fdni
揦	fton
揧	tomf
揨	fdot
揩	fug
揪	fhx
揫	hxjf
揬	fnvd
揭	fbsl
揮	fnc
揯	fytt
揰	fjtl
揱	wdnf
揲	fhlm
揳	ffdy
援	fjfa
揵	fefz
揶	fpp
揷	fjti
揸	fmbt
揹	fktd
揺	fjfu
揻	fjtx
揼	fcs
揽	fnkw
揾	fbq
揿	fvrv
搀	frod
搁	fnao
搂	fxr
搃	fvou
搄	fytt
搅	fwnw
搆	ffnl
搇	fvjk
搈	fnvo
搉	fpii
搊	fsuj
搋	fjjw
搌	fphk
損	fogv
搎	fzjm
搏	ftdd
搐	fdwq
搑	fhp
搒	fdnh
搓	fvfi
搔	fadq
搕	flgq
搖	fdlu
搗	fge
搘	fytb
搙	fjfd
搚	fjjd
搛	fvem
搜	fgia
搝	fjgd
搞	fdoo
搟	fcf
搠	fvud
搡	faam
搢	ftwb
搣	fjtx
搤	fvvq
搥	fjpz
搦	fzsv
搧	fdpj
搨	fbjj
搩	fdcm
搪	fjeo
搫	nswf
搬	fnsa
搭	fhvo
搮	fcm
搯	fjg
搰	fqd
搱	fpdx
搲	fnvn
搳	fnfo
搴	nfnf
搵	fqvq
搶	fvdo
搷	fxqv
搸	fevh
搹	ftoy
携	ftij
搻	vtof
搼	fvyf
搽	fhvm
搾	fnvk
搿	jfvf
摀	fjzh
摁	fqyu
摂	fpx
摃	figv
摄	fpaa
摅	fyu
摆	fqlg
摇	fjlu
摈	fngv
摉	fnvd
摊	fati
摋	fxma
摌	fdjl
摍	fntb
摎	fjjs
摏	fevg
摐	fsvl
摑	fqtx
摒	fpvh
摓	fafz
摔	fdwx
摔	fdvx
摕	fhwi
摕	fhni
摖	fxfm
摗	ftov
摘	fdno
摙	fcz
摚	fwnl
摛	fdxg
摜	fqxv
摝	fjzu
摞	fqwm
摟	fotr
摠	fjqu
摡	fegw
摢	fyji
摣	fyqf
摤	fyxx
摤	ftxv
摥	flbs
摦	fyfn
摧	feti
摨	fpsi
摩	jmmf
摪	fkdd
摫	ffvw
摬	fdbw
摭	fjhh
摮	lhaf
摯	lyxf
摯	lvxf
摰	lvlf
摱	fbqa
摲	fcjt
摳	fcoo
摴	fufs
摵	fjlx
摶	ftbd
摷	fsbm
摸	fhby
摹	hbyf
摺	fjjg
摻	fggs
摼	fgal
摽	fcfm
摾	fzsq
摿	fvdb
撀	ldjf
撁	fdyi
撂	fqao
撃	ccwf
撄	fbbr
撅	fjvv
撆	vnmf
撇	fvna
撈	fxxj
撉	dozf
撊	fnd
撋	fne
撌	fqgv
撍	fcwb
撎	flnv
撏	feid
撐	fwnj
撑	fwnf
撒	fhda
撓	fllw
撔	fbdm
撕	fhet
撖	fjpa
撗	fhdv
撘	fkvo
撙	fvud
撚	fdyh
撛	fxdi
撜	fxtv
撝	fjjh
撞	fdbl
撟	fjyo
撠	fxbx
撡	fggd
撢	fcbx
撣	foox
撤	fdga
撥	fxza
撦	fyyb
撧	fwml
撨	ftih
撩	fyvm
撪	fgyc
撫	flhh
撬	fjfl
播	fjxq
撮	fbpa
撯	fvfg
撰	feev
撱	fpxd
撲	fwtv
撳	fvrv
撴	fdoa
撵	ffvc
撶	fhtf
撷	flob
撸	frtb
撹	fwnw
撺	fnvi
撻	flvz
撼	fjtu
撽	fgda
撾	fqoz
撿	fvtv
擀	fxbf
擁	fdwi
擂	fuq
擃	fujk
擄	fyqj
擅	fdqt
擆	fhyb
擇	fqly
擇	fqlx
擈	fwtm
擉	fqsq
擊	cuwf
擋	fwnq
擌	fktv
操	foom
擎	hsof
擏	fhsa
擐	fqtk
擑	fopx
擒	fvdg
擓	fcsi
擔	frji
擕	ftim
擖	fhbl
擗	fpox
擘	podf
擙	fjny
據	fyx
擛	fhhm
擜	fxnd
擝	fbdq
擞	fxra
擟	ftvx
擠	fddh
擡	flol
擢	fjji
擣	fljd
擤	fjgn
擥	gkqf
擦	fnxm
擧	jksf
擨	fjjv
擩	fujn
擪	jbdf
擫	fjbd
擬	ftll
擭	fhta
擮	fltx
擯	fntv
擰	fnut
擱	fnao
擲	fvup
擳	fkep
擴	fjhv
擵	fjmf
擶	fkvn
擷	flov
擸	fsqv
擹	fhov
擺	fqgt
擻	fota
擼	frhb
擽	fwgm
擾	fjqa
擾	fjna
擿	fdnz
攀	mxxf
攁	fvek
攂	fqqq
攃	fhxm
攄	fyqu
攅	ffvv
攆	ffvc
攇	fnfu
攈	fjzh
攉	futi
攊	fjhl
攋	ftov
攌	fqqk
攍	fdld
攎	fyqq
攏	fdde
攐	fnfk
攑	fjkf
攒	fjlb
攓	fnfl
攔	fntm
攕	fvvx
攖	fgvr
攗	fjzx
攘	fdok
攙	frod
攚	fxxo
攛	fnvv
攜	feto
攝	fppp
攞	fqwi
攟	fjzh
攠	fjme
攡	fdxi
攢	fjlv
攣	wmif
攤	fhoi
攥	fkgm
攦	ftnu
攧	fxqv
攨	fnvn
攩	fwnh
攪	fjkw
攫	fgga
攬	fgkw
攭	fljq
攮	ftok
支	xabz
攰	xaj
攱	dxa
攲	ytoa
攳	xaed
攴	ya
攵	aii
收	lias
攷	tsa
攸	tia
改	zla
攺	ea
攻	ia
攼	fa
攽	vda
放	dha
政	tla
敀	ga
敁	yoya
敂	soa
敃	ptva
敄	dtja
故	xoa
敆	vtoa
敇	tnma
效	dvxa
敉	xa
敊	lmya
敋	aoa
敌	jxoa
敍	vtma
敎	xxza
敏	lqsa
敐	jfka
救	xxda
敒	tbia
敓	vowa
敔	woa
敕	toma
敖	lha
敗	gva
敘	vtma
教	yza
敚	vowa
敛	vtwa
敜	vjua
敝	vnma
敞	wnoa
敟	uva
敠	aaaa
敡	bssa
敢	jpa
散	hda
敤	bmya
敥	xxya
敦	doza
敧	ytoa
敨	doa
敩	wnza
敪	aaaa
敫	gdha
敬	hsoa
敭	bjja
敮	jxga
敯	ptva
数	xra
敱	etoa
敲	dona
敳	etoa
整	toml
敵	dnxa
敶	ptba
敷	tdia
數	otoa
敹	ynja
敺	cooa
敻	rnva
敼	lova
敽	jyoa
敾	vfva
敿	jyoa
斀	qsqa
斁	qlya
斁	qlva
斂	vtoa
斃	vnmt
斄	fmav
斄	fmam
斅	jkxa
斆	jkxa
文	dxbw
斈	dxz
斉	dxh
斊	dxp
斋	dxjn
斌	dxfv
斍	dxgw
斎	dxji
斏	dxdk
斐	neex
斐	enex
斑	edxe
斒	dxdh
斓	dxnm
斔	dxqv
斕	dxnm
斖	dxjf
斗	ddx
斘	dddx
料	xddx
斚	ggnx
斛	rddx
斜	vtmx
斝	oonx
斞	gvdx
斟	hevx
斠	fntx
斡	xbxx
斢	hdvx
斣	qsqx
斤	jjt
斥	jjtd
斦	jjtt
斧	vxjt
斨	kjjt
斩	cjjt
斪	sojt
斫	cjjt
斬	ccjt
断	xljt
斮	hbjt
斯	hevt
新	dmjt
斱	ybjt
斲	lzst
斲	ljst
斲	ljit
斲	ftjt
斳	holt
斴	xdct
斵	gdtt
斶	jjtq
斷	wwtt
斸	psqt
方	dhbf
斺	dhvn
斻	dhlw
於	dhvd
施	dhlc
斾	dhli
斿	dhlz
旀	dhgm
旁	dndh
旂	dhlt
旃	dhld
旄	dhll
旅	dhlk
旆	dhli
旇	dhla
旈	dhdm
旉	tdih
旊	dhld
旋	dhll
旌	dhll
旍	dhld
旎	dhlt
族	dhly
旐	dhlv
旑	dhyo
旒	dhlm
旓	dhld
旔	dhez
旕	dhvt
旖	dhlo
旗	dhlv
旘	dhdx
旙	dhjq
旚	dhlm
旛	dhlq
旜	dhlt
旝	dhlb
旞	dhlz
旟	dhlv
无	flaw
旡	cw
既	egcw
旣	gtcw
旤	qocw
日	biir
旦	bt
旧	ibuj
旨	tb
早	bxbz
旪	bx
旫	bd
旬	sbcx
旬	sbcs
旭	xbcx
旭	xbcs
旮	xbbg
旯	bxbl
旰	bfug
旱	bfbh
旲	by
旳	bsd
旴	bf
旵	be
时	bxds
旷	bj
旸	bzs
旹	ulb
旹	uitb
旺	beuw
旻	bdx
旼	bdx
旽	btul
旾	tulb
旿	blx
昀	bsv
昁	btni
昂	bcp
昃	bjv
昄	bjja
昅	bjzn
昆	bu
昇	bjh
昈	bdp
昉	bdh
昊	bty
昋	tyb
昌	bb
昍	bb
明	bdum
昏	ctvb
昐	bvd
昑	bvj
昒	bss
易	bss
昔	hbbx
昕	bjjt
昖	bvg
昗	bdv
昘	bdh
昙	bfg
昚	yvb
昛	bg
昜	btss
昜	bjjs
昝	ayb
昞	btnv
星	bjls
映	bny
昡	bdw
昢	bue
昣	bvs
昤	bvjd
春	evb
昦	byn
昧	bfm
昨	blk
昩	btm
昪	bgh
昫	bso
昬	ptvb
昭	bdoz
昮	bij
是	btl
昰	btl
昱	bdby
昲	bzsn
昳	bkv
昴	bcjp
昵	bpt
昶	djxb
昷	bq
昸	badd
昹	bdjx
昺	btnv
昻	bip
昼	pnbt
昽	bxtd
显	bwt
昿	bjg
晀	bvwv
晁	bvwv
時	blxd
晃	bww
晄	bww
晅	btbt
晆	bll
晇	byfs
晈	bdvx
晉	tggb
晊	btgl
晋	twtb
晌	bjno
晍	bnto
晎	bhv
晏	bnr
晐	bdyv
晑	bjno
晒	bc
晓	bxtw
晔	bttx
晕	bncy
晖	bnch
晗	bvjo
晘	bbf
晙	bgva
晚	brow
晛	bgw
晜	bvzj
晝	elbt
晞	bxxi
晟	bjjx
晠	bjjx
晡	btdd
晢	fjjb
晣	bfjt
晤	bwo
晥	bnfw
晦	blqs
晧	bjlo
晨	bjfk
晩	brbw
晪	buv
晫	bybx
晬	bdvx
晭	bnlo
普	vwtb
景	bdom
晰	bmjt
晱	bxx
晲	bgw
晳	mjjb
晴	bld
晵	dpab
晶	bbbj
晷	bayo
晸	btla
晹	bbss
智	lyob
晻	bybl
晼	bndc
晽	bmm
晾	bdom
晿	bbb
暀	bsde
暁	bxhw
暂	cjjb
暃	bnee
暃	bene
暄	bntt
暅	bytt
暆	bdhc
暇	bpfa
暈	bnc
暉	bnc
暊	bjgv
暋	ptvb
暌	bxty
暍	bbsl
暎	bhny
暏	byb
暐	bzii
暑	bybs
暒	bbjl
暓	dtjb
暔	bxny
暔	bxnx
暕	btqm
暖	bjfa
暗	bdb
暘	bbts
暘	bbjs
暙	bevb
暚	bjlu
暛	bvfi
暜	ddb
暝	bnbv
暞	bjgm
暟	betv
暠	bdoo
暡	bvgj
暢	bibs
暣	bkzx
暤	bgyx
暥	bbnr
暦	jmmb
暧	bjna
暨	egct
暩	bxfm
暪	bhnd
暫	ccjb
暬	lvlb
暭	bgxx
暮	hbyb
暯	bhby
暰	bsvl
暱	bcho
暲	bdbx
暳	bffe
暴	bhvs
暵	bhov
暶	bdhl
暷	btbd
暸	byvm
暹	btiz
暺	boox
暻	bbdm
暼	vnmb
暽	bxdi
暾	bdoa
暿	bloo
曀	blnv
曁	gtct
曂	bhdv
曃	besz
曄	bhtf
曅	bhtf
曆	jhhb
曇	bufg
曈	bdbl
曉	bllw
曊	bzsv
曋	bcbx
曌	bdni
曍	bjgx
曎	bqly
曎	bqlx
曏	bwjp
曐	bbbl
曑	bbbs
曒	bgda
曓	buex
曔	bhsa
曕	brji
曖	bjna
曗	bwtm
曘	bujn
曙	bqyb
曚	bhnx
曛	bjth
曜	bjji
曝	bbhs
曞	bjhg
曟	bbbk
曠	bjhv
曡	bbbf
曢	bnym
曣	bhoh
曣	bhkh
曤	buti
曥	byqq
曦	bvex
曧	btoq
曨	bdde
曩	bdok
曪	bqwi
曫	wmib
曬	btnu
曭	bwnh
曮	booa
曯	bpsq
曰	biiy
曱	qii
曲	uiiq
曲	uiic
曳	bxay
更	tbx
曵	bxd
曶	ssb
曷	bsvl
書	elb
曹	ub
曺	tdb
曺	tbib
曻	bdci
曼	bqa
曽	vqb
曾	vqb
替	fvfb
最	bpa
朁	cwcb
朂	gpj
會	vtqb
朄	bitm
朅	lgbl
朆	vqbs
朇	vtqx
月	dii
有	xdcy
有	xdby
朊	dfw
朋	ddup
朌	dvd
服	dpa
朎	dvjd
朏	due
朐	dso
朑	dhl
朒	dnvv
朓	dvwv
朔	vujd
朕	dvy
朖	ddek
朗	degd
朘	dgva
朙	qvnd
朚	dlbd
望	dlde
朜	ddoz
朝	xbxd
朞	hevd
期	hevd
朠	dhny
朡	dxua
朢	gde
朣	ddbl
朤	dddd
朥	dxxj
朦	dhnx
朧	ddde
木	miim
朩	mii
未	fmaw
末	tmam
本	mtab
札	mluz
朮	xwd
术	mdas
朰	mz
朱	kmaz
朲	mv
朳	mv
朴	myup
朵	wmbd
朶	zjm
朷	md
朸	mj
朹	mx
机	mw
朻	mli
朼	mt
朽	mts
朾	mt
朿	tnm
杀	xmbs
杁	mjn
杂	xmbz
权	mauq
权	mauc
杄	mjx
杅	mf
杆	mfug
杇	mfs
杈	mad
杉	msus
杊	mm
杋	mwd
杌	mtw
杍	mz
李	mzbl
杏	mo
材	mxj
村	mxdc
杒	mdd
杓	msd
杔	mjt
杕	my
杖	mxn
杗	dlm
杘	pm
杙	mv
杚	mlz
杛	mzs
杜	mlud
杝	mc
杞	mzl
束	toms
杠	miug
条	am
杢	mi
杣	me
杤	mth
来	txal
杦	mrn
杧	mdl
杨	mzs
杩	mst
杪	mmj
杫	ml
杬	mfw
杭	mdw
杮	mtni
杯	mjy
杰	mhbj
東	tbm
杲	bmbg
杳	mb
杴	mrv
杵	mlx
杶	mtul
杷	mdl
杸	mwa
杹	mtt
杺	mu
杻	mjxt
杼	mdt
杽	mjf
松	mvg
板	mjja
枀	vgm
极	mjzn
枂	md
枃	msv
构	msg
枅	mth
枆	mjfl
枇	muup
枈	um
枉	meuw
枊	mcp
枋	mdh
枌	mvd
枍	mvts
枎	mfv
枏	mnf
析	mjjt
枑	mtlt
枒	mcij
枓	mddx
枔	mvj
枕	mpl
枖	mjy
林	mmul
枘	mnv
枙	mjc
枚	maum
枛	mj
果	bmag
枝	mxa
枞	mvv
枟	mfg
枠	mxx
枡	mjh
枢	mcx
枣	tnmd
枤	myd
枥	mjj
枦	mdp
枧	mnw
枨	mk
枩	mvg
枪	mvc
枫	mwx
枬	mnd
枭	gm
枮	myo
枯	mxo
枰	mtvi
枱	mgo
枲	gom
枳	mov
枴	mod
枵	mots
架	jom
枷	mjo
枸	mso
枹	mse
枺	mtm
枻	mhl
枼	hlm
枽	xhm
枾	mxh
枿	mxh
柀	mja
柁	mntd
柂	mlc
柃	mvjd
柄	mtnv
柅	mpt
柆	md
柇	mh
柈	mvx
柉	mjdz
柊	madd
柋	tvm
柌	mjto
柍	mny
柎	mtxd
柏	mgub
某	hfm
柑	mhf
柒	stmq
柒	stmc
染	sxm
柔	dtjm
柕	mdtj
柖	mdo
柗	mvo
柘	mc
柙	mq
柚	mduy
柛	mbi
柜	mgug
柝	mjjd
柞	mlk
柟	mnl
柠	mntn
柡	mfs
柢	mctd
柣	mkv
柤	mqf
查	mbt
柦	mbt
柧	mjjn
柨	mxni
柩	mcrd
柪	mwj
柫	mzsn
柬	tqm
柭	mxad
柮	mue
柯	mto
柰	mfmn
柱	mde
柲	muj
柳	mcjp
柴	ltm
柵	mnh
柶	mq
柷	mow
柸	mjyt
柹	msij
柹	mjsj
柺	moj
査	mqf
柼	mnv
柽	mal
柾	mtl
柿	mdni
栀	mjjc
栁	mdp
栂	mqs
栃	mjjh
栄	wnm
栅	mnnt
栆	toid
标	mfmb
栈	mfx
栉	mhp
栊	mxtd
栋	mtm
栌	myp
栍	mjl
栎	mcm
栏	mvel
栐	mdjx
树	maxd
栒	msb
栓	mve
栔	fdm
栕	mg
栖	mcuq
栖	mcuc
栗	cmbl
栘	mdd
栙	maci
栚	mvy
栛	mjjj
栜	mtnm
栝	mjxo
栞	ffm
栟	mvh
栠	tjlm
校	mdvx
栢	mjb
栣	mtjl
栤	mvs
栥	vrvm
栦	myyy
栧	mbx
栨	mvrv
栩	mjj
株	mkm
栫	mxiz
栬	mrdl
栭	mjnn
栮	mp
栯	mxd
栰	mtx
栱	mhv
栲	mys
栳	myt
栴	mlnd
栵	mtdn
栶	mqy
样	mvf
核	mdyv
根	mek
栺	mtb
栻	mtiv
格	mao
栽	lmx
栾	dmm
栿	mtyd
桀	dcim
桁	msfi
桂	mll
桃	mvwv
桄	mww
桅	mrjc
框	mce
桇	rom
案	nrm
桉	mnr
桊	vym
桋	mtzv
桌	ybm
桍	myfs
桎	mtgl
桏	mip
桐	mnto
桑	aaam
桒	xhm
桓	mtbt
桔	mlo
桕	mguj
桖	mjq
桗	mzjm
桘	mjpz
桙	mgki
桚	msd
桛	mltd
桜	mwr
桝	mdci
桞	mdp
桟	mex
桠	mtwt
桡	mxtw
桢	myb
档	mwe
桤	mezl
桥	mjyn
桦	mttx
桧	mvfg
桨	kdm
桩	mjl
桪	mexd
桫	msmj
桬	smjm
桭	mjfk
桮	mjyo
桯	moe
桰	mcto
桱	mtsi
桲	mxnz
桳	mgyx
桴	mjz
桵	mjr
桶	mdnf
桶	mddi
桷	mr
桸	mxxi
桹	mdek
桺	mtjz
桺	mtcz
桻	maf
桼	mvs
桽	mvvl
桾	mejo
桿	mbf
梀	mtom
梁	sdvm
梂	mxxd
梃	mjlz
梄	mu
梅	mlqs
梆	mfp
梇	meh
梈	mdoj
梉	mkl
梊	fjjm
梋	mod
梌	mvtm
梍	mgt
梎	mgt
梏	mjlo
梐	mul
梑	mxjx
梒	mvjo
梓	mdx
梔	mjjl
梕	mddu
梖	mgv
梗	mtbx
梘	mgw
梙	mooi
梚	mrow
梛	mdfp
梜	myvv
梜	mtvv
條	tiam
梞	mzlu
梟	gm
梠	moo
梡	mnfw
梢	mwd
梣	mevj
梤	mevd
梥	nvgm
梦	mmd
梧	mwo
梨	hnml
梩	mbl
梪	mtov
梫	mena
梬	mdts
梭	mgva
梮	mpjo
梯	mvzj
械	mthx
梱	mqm
梲	mvow
梳	mdgm
梴	mjlz
梵	mmwd
梶	mpjl
梷	yoam
梸	mhn
梹	mgv
梺	mmtd
梻	mtzn
梼	mfxd
梽	mlu
梾	mtx
梿	mcz
检	mvtw
棁	mvow
棂	mex
棃	hsjm
棄	dghm
棅	mjtm
棆	mvth
棇	mvgu
棈	mld
棉	mgni
棊	hevm
棋	mhev
棌	mjm
棍	mbu
棎	mnvm
棏	mbtd
棐	neem
棐	enem
棑	mnee
棑	mene
棒	mevf
棓	mdo
棔	mctb
棕	mnfm
棖	mk
棗	tnmm
棘	tnmm
棙	mdpd
棚	mdd
棛	mdgd
棜	mdhd
棝	mqxo
棞	mqh
棟	mtbm
棠	wnom
棡	mnve
棢	mnvl
棣	mes
棤	mhb
棥	mxxm
棦	mrei
棧	mxx
棨	dpam
棩	mktk
棪	mxx
棫	mtox
棬	mvyc
棭	mdtn
森	mmm
棯	mvju
棰	mjxf
棰	mjtl
棱	mlva
棲	mter
棳	maaa
棴	mdpa
棵	mbm
棶	mxvv
棶	mtvm
棷	mpa
棸	pam
棹	mybx
棺	mnpz
棻	hvdm
棼	mmvd
棽	mmvj
棾	mmnw
棿	mgw
椀	mndc
椁	mdoz
椂	mesl
椃	myw
椄	mdr
椅	myto
椆	mnlo
椇	mqev
椈	msx
椉	ddcm
椊	mdvx
椋	mdom
椌	mnvi
植	mxqe
椎	mti
椏	mtxt
椐	mpxo
椑	mgjx
椒	mlma
椓	mxd
椔	msq
椕	mvdm
椖	mdph
椗	mntl
椘	mmdz
椙	mbb
椚	mn
椛	mhtt
検	mvtv
椝	fvnm
椞	mjjm
椟	mxjy
椠	cjjm
椡	mtgn
椢	mqed
椣	muv
椤	mqd
椥	mlyo
椦	mvyj
椧	mvtp
椨	mjtd
椩	mjev
椪	mvwt
椫	mvbx
椬	mnqf
椭	mpxd
椮	mgys
椯	mejn
椰	mpp
椱	mlba
椲	mzii
椳	mqtk
椴	mjia
椵	mpfa
椶	mxua
椷	mjtx
椸	mdhc
椹	mhel
椺	mtom
椻	mcbr
椼	mssi
椽	mljx
椾	mvdn
椿	mevb
楀	mjog
楁	mnao
楂	mmbt
楃	mptl
楄	mdph
楅	mtoq
楆	mcr
楇	mqo
楈	mjld
楉	mhxo
楊	mbts
楊	mbjs
楋	mton
楌	mdjs
楍	mooo
楎	mnc
楏	myll
楐	mqvn
楑	mxty
楒	mqu
楓	mwjq
楔	mfdy
楕	mxid
楖	megp
楗	mefz
楘	dtjm
楙	mdtm
楚	mmjl
楛	mhxo
楜	mxod
楝	mtqm
楞	mqdh
楟	mdot
楠	mxny
楠	mxnx
楡	mvtk
楢	mvu
楣	mdjg
楤	mssu
楥	mjfa
楦	mntt
楧	mhny
楨	mygv
楩	mttx
楪	mhlm
楫	mop
楬	mbsl
業	wtvm
楮	myb
楯	mjjg
楰	mgv
楱	mevy
楲	mjtx
楳	mhfm
楴	mdni
極	mjot
楶	vrvm
楷	mug
楸	mhx
楹	mzjq
楺	mdtm
楻	mge
楼	mxr
楽	vgvm
楾	mgs
楿	mhb
榀	mooo
榁	mntl
概	megw
榃	mmq
榄	mnkw
榅	mbq
榆	mvtn
榇	mdm
榈	mnoo
榉	mwvf
榊	mjyi
榋	meee
榌	mzvv
榍	mpwd
榎	mjga
榏	mvvq
榐	mphk
榑	mtdd
榒	mzsv
榓	mujq
榔	mdep
榕	mnvo
榖	lnta
榗	mtwb
榘	lygm
榙	mhvo
榚	mveh
榛	mevh
榜	mdnh
榝	mxma
榞	mjgm
榟	mndx
榠	mnbv
榡	mlwm
榢	mnx
榣	mjlu
榤	mdcm
榥	mbww
榦	xbxm
榧	mcee
榨	mnvk
榩	mydx
榪	msh
榫	mtix
榬	mlok
榭	mrxd
榮	xxnm
榯	mbld
榰	mytb
榱	mdok
榲	mqvq
榳	mjjz
榴	mgdq
榵	mhp
榶	mjeo
榷	mpii
榸	mlbl
榹	mjjw
榺	dvym
榻	mbjj
榼	mlgq
榽	mjwy
榾	mqd
榿	metv
槀	donm
槁	mdoo
槂	mzjm
槃	nswm
槄	mjg
槅	mtoy
槆	mhsb
槇	mtgv
槈	mjfd
槉	mjly
槊	vujm
構	mfnl
槌	mjpz
槍	mvdo
槎	mvfi
槏	mvem
槐	mgwg
槑	omom
槒	mdwq
槓	migv
槔	mgyx
槕	mybm
槖	lncm
槗	mxoo
様	mves
槙	mxqv
槚	mcb
槛	mnkq
槜	mtij
槝	mge
槞	mdbl
槟	mngv
槠	miyb
槡	maam
槢	mjjg
槣	mnyo
槤	mcz
槥	mffe
槦	mjei
槧	ccjm
槨	mdop
槩	gtcm
槪	mgtw
槫	mtbd
槬	myfn
槭	mjlx
槮	mggs
槯	meti
槰	mafz
槱	muh
槲	mrdx
槳	kdxm
槴	mdpl
槵	moou
槶	mqtx
槷	lvlm
槸	mlvd
槹	mgxx
槺	mjes
槻	mfvw
槼	fvgm
槽	mub
槾	mbqa
槿	mhol
樀	mdno
樁	mevg
樂	wgwm
樃	mded
樄	mptm
樅	msvl
樆	mdxg
樇	mtid
樈	mdbw
樉	myxx
樉	mtxv
樊	mxxy
樋	mdnz
樋	mddz
樌	mqxv
樍	mlgv
樎	mntb
樏	mqwm
樐	myqd
樑	msdm
樒	mnue
樓	motr
樔	msbm
樕	mtov
樖	vtoo
樗	mufs
樘	mwnl
標	mcfm
樚	mjzu
樛	mjjs
樜	mjhh
樝	myqf
樞	mcoo
樟	mdbx
樠	mhnd
模	mhby
樢	mgh
樣	mvex
樤	mtim
樥	mhaf
樦	mkde
樧	mxma
樨	mpsi
権	mlxi
横	mhdv
樫	mgal
樬	mjqu
樭	mhel
樮	mcx
樯	mxvo
樰	mue
樱	mbbr
樲	mtfv
樳	meid
樴	mdbx
樵	mtih
樶	mbpa
樷	mmpa
樸	mwtv
樹	mlod
樺	mhtf
樻	mqgv
樼	mpzz
樽	mvud
樾	mllx
樿	moox
橀	mdgq
橁	mksb
橂	mvuy
橃	mxza
橄	mjpa
橅	mlhh
橆	lhmm
橇	mjfl
橈	mllw
橉	mxdi
橊	mtnq
橊	mtcq
橋	mjyo
橌	mnd
橍	mne
橎	mjxq
橏	mvfo
橐	toim
橑	myvm
橒	mufg
橓	mjni
橔	mdoa
橕	mwnj
橖	mwnm
橗	mhbd
橘	mdto
橙	mxtv
橚	meik
橛	mjvv
橜	jvum
橝	mcbx
橞	mtbu
機	mwwx
橠	mddk
橡	mrox
橡	mrbx
橢	mpxd
橣	mnui
橣	mnuf
橤	uuum
橥	xjym
橦	mdbl
橧	mvqb
橨	mxhv
橩	mxxx
橪	mdyh
橫	mhtv
橬	mcwb
橭	mxox
橮	mgdv
橯	mxxj
橰	mjgx
橱	mjtd
橲	mloo
橳	mdvj
橴	mltm
橵	mhda
橶	mxbx
橷	mkgw
橸	mbbb
橹	mrtb
橺	mnb
橻	mjxt
橼	mwlx
橽	mlvz
橾	moom
橿	mtqt
檀	mdqt
檁	mdqh
檂	mujk
檃	pjim
檄	mgda
檅	mljx
檆	mxxo
檇	mtim
檈	mqtk
檉	mpoe
檊	mxbf
檋	mhvc
檌	mqne
檌	mqee
檍	mdbu
檎	mvdg
檏	mwtm
檐	mrji
檑	muq
檒	mmwq
檓	mgea
檔	mwnq
檕	cuwm
檖	mvxz
檗	podm
檘	mpox
檙	mgkk
檚	mmml
檛	mqoz
檜	mvtb
檝	mopx
檞	mrdi
檟	mcgv
檠	hsom
檡	mqly
檡	mqlx
檢	mvtv
檣	mxvo
檤	mvjz
檥	mvex
檦	mcfn
檧	mhsu
檨	mvev
檩	mdqm
檪	mvgm
檫	mnxm
檬	mhnx
檭	mvek
檮	mljd
檯	mlol
檰	mwmi
檱	mkhv
檲	mqtd
檳	mntv
檴	mhta
檵	mwwl
檶	myco
檷	mtvx
檸	mnut
檹	mdho
檺	mdox
檻	mgkq
檼	mjiu
檽	mujn
檾	xxnm
檿	jbdm
櫀	mhem
櫁	mnuq
櫂	mjji
櫃	mcqv
櫄	mjth
櫅	mddh
櫆	mgwx
櫇	mjav
櫈	mxtw
櫉	mjld
櫊	mnao
櫋	mjgh
櫌	mjqa
櫌	mjna
櫍	mjjv
櫎	mjhv
櫏	mcyz
櫐	qqqm
櫑	mqqq
櫒	mhxm
櫓	mrhb
櫔	mjhg
櫕	mfvv
櫖	myqu
櫗	mhqx
櫘	mffu
櫙	mhco
櫚	mnoo
櫛	mkep
櫜	toim
櫝	mlqv
櫞	mwmx
櫟	mwgm
櫠	mjxa
櫡	mkyb
櫢	mota
櫣	mhcz
櫤	mkvn
櫥	mjld
櫦	mjza
櫧	miyb
櫨	myqq
櫩	mnrg
櫪	mjhl
櫫	xybm
櫬	mdmw
櫭	megt
櫮	meoo
櫯	mrhh
櫰	mdqk
櫱	ujjm
櫲	mdtx
櫳	mdde
櫴	mtov
櫵	mhth
櫶	mnfu
櫷	mjq
櫷	mjlt
櫷	mjll
櫸	mjkf
櫹	mhek
櫺	muoo
櫻	mgvr
櫼	mvvx
櫽	mjim
櫾	mjlm
櫿	mxxo
欀	mdok
欁	mujm
欂	mhsd
欃	mrod
欄	mntm
欅	mjkf
欆	mtia
欇	mppp
欈	meto
欉	mwta
權	mhoi
欋	mggi
欌	mhkx
欍	mhtg
欎	mxxd
欏	mqwi
欐	mtnu
欑	mjlv
欒	wmim
欓	mwnh
欔	mgga
欕	mooa
欖	mgkw
欗	mhnm
欘	mpsq
欙	mqqm
欚	mljq
欛	muhd
欜	mtok
欝	mxxd
欞	muov
欟	mhow
欠	rv
次	vrvc
欢	arv
欣	jjtv
欤	srv
欥	brv
欦	vjrv
欧	cxrv
欨	sorv
欩	dorv
欪	uerv
欫	lxtv
欫	ltlv
欫	klrv
欬	dyvv
欭	qyrv
欮	vujv
欯	lorv
欰	jqrv
欱	vtov
欲	vvov
欳	ynhv
欴	degv
欵	tlyv
欶	tomv
欷	xxnv
欸	glyv
欹	ytov
欺	hevv
欻	xxrv
欼	aaav
欽	vvrv
款	lfmv
欿	rgrv
歀	mfmv
歁	hevv
歂	ejnv
歃	jxgv
歄	qorv
歅	clrv
歆	dbrv
歇	bsvv
歈	vtdv
歉	vemv
歊	donv
歋	jjyv
歌	totv
歍	jztv
歎	hofv
歏	holv
歐	coov
歑	yjvv
歒	dnxv
歓	lxiv
歔	ywtv
歕	xhgv
歖	lovv
歗	eikv
歘	xxxv
歙	vtov
歚	vfvv
歛	vtov
歜	qsqv
歝	qlyv
歝	qlvv
歞	bwwv
歟	jksv
歠	aaav
歡	hoov
止	liiz
正	tlbz
正	tlaz
此	ltuc
步	yiib
武	flv
歧	lxa
歨	ll
歩	lmj
歪	jytl
歫	lg
歬	lns
歭	llxd
歮	lll
歯	lxu
歰	dddl
歱	ljtl
歲	ljtx
歳	ljtx
歴	jmml
歵	llgv
歶	ltbg
歷	jhhl
歸	jpzi
歹	tdbd
歹	tdad
歺	yd
死	tdt
歼	tdjx
歽	tdjt
歾	tdss
歿	tdha
殀	tdjy
殁	tdwa
殂	tdqf
殃	tdny
殄	tdvs
殅	tdjl
殆	tdgo
殇	tdls
殈	tdjq
殉	tdsb
殊	tdkm
残	tdfx
殌	tdti
殍	tdjz
殎	tdtv
殏	tdxd
殐	tdtm
殑	tdxw
殒	tdob
殓	tdvw
殔	tdes
殕	tddo
殖	tdxe
殗	tdyl
殘	tdxx
殙	tdcb
殚	tdvx
殛	tdjt
殜	tdhm
殝	tdeh
殞	tdov
殟	tdbq
殠	tdjd
殡	tdnv
殢	tdhi
殣	tdhl
殤	tdls
殥	tdnv
殦	tdgh
殧	tddd
殨	tdqv
殩	tdyx
殪	tdlv
殫	tdox
殬	tdqy
殬	tdqx
殭	tdtt
殮	tdvv
殯	tdnv
殰	tdlv
殱	tdlx
殲	tdvx
殳	wa
殴	cxwa
段	jiea
殶	dewa
殷	jjea
殸	ldja
殹	clya
殺	xmwa
殻	lnwa
殼	lnta
殽	xxda
殾	ybwa
殿	phva
毀	glwa
毁	giwa
毂	lnca
毃	dona
毄	cowa
毅	dxwa
毆	cooa
毇	gxwa
毈	cypa
毉	clyv
毊	ldjo
毋	qxaw
毌	qx
母	qsam
毎	lqx
每	lqs
毐	lqx
毑	qsc
毒	lqsd
毓	lqsm
比	uiib
毕	uxbb
毖	uuj
毗	quup
毘	qu
毙	utdt
毚	roud
毛	jfl
毜	jflm
毝	jfls
毞	ujfl
毟	mjjl
毠	jojl
毡	jflo
毢	jflc
毣	jjjl
毤	vgwl
毥	jflb
毦	pjfl
毧	jflx
毨	jflw
毩	jflx
毪	jfli
毫	donl
毬	jfld
毭	tovl
毮	fmjl
毯	jflx
毰	jflo
毱	jflx
毲	aaal
毳	jfll
毴	jfle
毵	gysl
毶	jfls
毷	bgjl
毸	jflu
毹	vtdl
毺	jfln
毻	xidl
毼	bsvl
毽	jflz
毾	bjjl
毿	gggl
氀	otol
氁	jfly
氂	fmal
氃	dbll
氄	dtjl
氅	wnol
氆	jflb
氇	jflb
氈	dqol
氉	oool
氊	jflt
氋	hnfl
氌	jflb
氍	ggtl
氎	qqql
氏	ctv
氐	ctvd
民	ptv
氒	ctvx
氓	dlpv
气	kz
氕	kzj
氖	kzzj
気	kzx
氘	kzn
氙	kze
氚	kzm
氛	kzvd
氜	kzb
氝	kznv
氞	kztv
氟	kzzn
氠	kzbi
氡	kzad
氢	kzzi
氣	kzx
氤	kzqy
氥	kzc
氦	kzdv
氧	kzvf
氨	kznr
氩	kztt
氪	kzxw
氫	kzti
氬	kztt
氭	kztm
氮	kzxx
氯	kzes
氰	kzld
氱	kzbs
氲	kzbq
氳	kzqq
水	sii
氵	sii
氶	jx
氷	ds
永	djx
氹	zs
氺	sii
氻	sj
氼	sv
氽	vsbt
氾	sc
氿	sx
汀	stut
汁	sxuz
求	xxdc
汃	sv
汄	sv
汅	sts
汆	jns
汇	scuh
汈	sjt
汉	sauh
汊	sad
汋	ssd
汌	sm
汍	sxd
汎	swd
汏	sy
汐	sdux
汐	sdus
汑	sjt
汒	sdl
汓	sz
汔	slz
汕	seus
汖	es
汗	sfuh
汘	sjx
汙	sf
汚	stts
汛	szx
汜	se
汝	sr
汞	is
江	siuj
池	scuc
污	sfs
汢	sl
汣	srn
汤	szs
汥	sxa
汦	sctv
汧	sth
汨	sbum
汩	sbug
汪	seuw
汫	sfn
汬	fns
汭	snv
汮	ssv
汯	sxg
汰	syd
汱	syd
汲	sjzn
汳	sjja
汴	sdy
汵	svj
汶	sdx
汷	sa
汸	sdh
汹	sxux
決	szv
汻	slx
汼	ski
汽	skz
汾	svd
汿	sdt
沀	sdt
沁	suuq
沁	suuc
沂	sjjt
沃	sjy
沄	sfg
沅	sfw
沆	sdw
沇	sgw
沈	spl
沉	snw
沊	pls
沋	sxld
沌	stul
沍	stlt
沎	stt
沏	stdq
沐	smum
沑	sjxt
沒	sha
沓	sb
沔	stlj
沕	sss
沖	soi
沗	tys
沘	su
沙	smj
沚	sl
沛	stni
沜	sk
沝	ss
沞	stni
沟	ssg
沠	sj
没	swam
沢	spn
沣	sfuf
沤	scx
沥	sjj
沦	svt
沧	svc
沨	swx
沩	sdjd
沪	sdp
沫	stmm
沬	sfm
沭	smd
沮	sqf
沯	sc
沰	sc
沱	snt
沲	slc
河	sto
沴	svs
沵	srm
沶	sfm
沷	sxad
沸	szsn
油	sduy
沺	sq
治	sgo
沼	sdo
沽	sxo
沾	syo
沿	swoy
泀	sjto
況	sow
泂	sno
泃	sso
泄	shl
泅	sqv
泆	skv
泇	sjo
泈	sadd
泉	gs
泊	sgub
泋	sxh
泌	suj
泍	smt
泎	slk
泏	sue
泐	spj
泑	swj
泒	sjjn
泓	szsg
泔	shf
法	slg
泖	scjp
泗	squs
泘	sjvi
泙	stvi
泚	slt
泛	sjdz
泜	sctd
泝	sjjd
泞	snt
泟	stl
泠	svjd
泡	sse
波	sja
泣	sduq
泤	sldv
泥	spt
泦	spx
泧	scx
注	sde
泩	sjl
泪	sgul
泫	sdw
泬	snv
泭	stxd
泮	svx
泯	sptv
泰	evst
泱	sny
泲	ssij
泲	sjsj
泳	sdjx
泴	sq
泵	csbb
泶	wns
泷	sxtd
泸	syp
泹	sbt
泺	scm
泻	sns
泼	syad
泽	saf
泾	szi
泿	sek
洀	sns
洁	slo
洂	sdm
洃	sxx
洄	sqo
洅	stnl
洆	sjxt
洇	sqy
洈	srjc
洉	sjjo
洊	sxiz
洋	svfy
洌	stdn
洍	sg
洎	sjg
洏	sjnn
洐	ssfi
洑	styd
洒	scus
洓	stnm
洔	slxd
洕	svd
洖	soty
洗	sjlw
洘	sys
洙	skm
洚	saci
洛	sao
洜	aos
洝	snr
洞	snto
洟	stzv
洠	sgki
洡	sem
洢	stej
洣	sx
洤	sve
津	sefj
洦	sjb
洧	sxd
洨	sdvx
洩	sbx
洪	shv
洫	sjq
洬	swtd
洭	sce
洮	svwv
洯	fds
洰	sg
洱	sp
洲	syyy
洳	sro
洴	svh
洵	ssbx
洶	ssxu
洷	stgl
洸	sww
洹	stbt
洺	sdo
活	sjxo
洼	sll
洽	svto
派	sjjk
洿	syfs
浀	su
流	sdgm
浂	svy
浃	stvv
浄	srei
浅	sfx
浆	kds
浇	sxtw
浈	syb
浉	snti
浊	squz
测	sbn
浌	stx
浍	svfg
济	sdxn
浏	sdxn
浐	sdj
浑	snch
浒	silx
浓	spk
浔	sexd
浕	spnd
浖	sjxd
浗	sxxd
浘	spjl
浙	sfjt
浚	sgva
浛	svjo
浜	sgv
浝	sxld
浞	sol
浟	stia
浠	sxxi
浡	sxnz
浢	stov
浣	snfw
浤	snxg
浥	sodl
浦	stdd
浧	soe
浨	snm
浩	sjlo
浪	sdek
浫	snvf
浬	sbl
浭	stbx
浮	sjz
浯	swow
浰	shn
浱	sjfk
浲	saf
浳	svd
浴	svvo
浵	snds
浶	snki
海	slqs
浸	sena
浹	syvv
浹	stvv
浺	syoi
浻	snvo
浼	srow
浽	sjr
浾	slm
浿	sgv
涀	sgw
涁	sms
涂	svtm
涃	sqm
涄	sdts
涅	sbl
涆	sbf
涇	stsi
消	swd
涉	syus
涊	sddu
涋	snyd
涌	sdnf
涌	sddi
涍	syz
涎	sjlz
涏	sjlz
涐	sjfx
涑	stom
涒	sejo
涓	sod
涔	sevj
涕	svzj
涖	std
涗	svow
涘	sgly
涙	sdpy
涚	svow
涛	sfxd
涜	slnw
涝	shnj
涞	stx
涟	scz
涠	sqfi
涡	sonv
涢	sob
涣	srny
涤	sam
涥	sdoj
润	sner
涧	snbj
涨	szsk
涩	sddl
涪	sdof
涫	snpz
涬	sly
涬	slvx
涭	sjna
涮	spnn
涯	sjll
涰	saaa
涱	sk
液	sdtn
涳	snvi
涴	sndc
涵	sjxu
涶	sjxf
涶	sjtl
涷	stbm
涸	sqxo
涹	shr
涺	spxo
涻	svfo
涼	sdom
涽	sctb
涾	ssb
涿	sxd
淀	sntl
淁	sdr
淂	sbtd
淃	svyc
淄	ssq
淅	smjt
淆	sxxd
淇	shev
淈	spue
淉	sbm
淊	srg
淋	smm
淌	swno
淍	snlo
淎	sevf
淏	sbty
淐	sbb
淑	slma
淒	ster
淓	shdh
淔	sxqe
淕	slvl
淖	sybx
淗	ssx
淘	sslu
淙	snfm
淚	sdpd
淛	sknn
淜	sdd
淝	sddl
淞	smvg
淟	suv
淠	sqtn
淡	sxx
淢	stox
淣	sgw
淤	sdhd
淥	sljs
淦	svug
淧	snuj
淨	sjei
淩	slva
淪	svth
淫	sjjl
淬	sdvx
淭	sdpm
淮	sti
淯	sdgd
淰	svju
深	snvm
淲	syw
淳	sdoz
淴	sssu
淵	sktk
淶	sxvv
淶	stvm
混	sbu
淸	slnl
淹	sybl
淺	sxx
添	styd
淼	sss
淽	shl
淾	vs
淿	sgni
渀	syxh
渁	sss
渂	sbdx
渃	shxo
渄	snee
渄	sene
清	sld
渆	svhn
渇	sbst
済	sdxh
渉	slmj
渊	sjxi
渋	slx
渌	ses
渍	slb
渎	sxjy
渏	syto
渐	scjt
渑	sobl
渒	sgjx
渓	sjfv
渔	srt
渕	svyn
渖	snbi
渗	sgys
渘	sdtm
渙	srny
渚	syb
減	sjtx
渜	sjny
渝	svtn
渞	svjg
渟	sdot
渠	sgm
渡	sjha
渢	swjq
渣	smbt
渤	sxnj
渥	sptl
渦	sqo
渧	sdni
渨	sqtk
温	sbq
渪	sjog
渫	shlm
測	sgvn
渭	sqdw
渮	shto
港	shve
渰	svth
渱	sqi
渲	sntt
渳	szsp
渴	sbsl
渵	shq
渶	shny
渷	sdvw
游	sdhz
渹	ssi
渺	sgmj
渻	smjg
渼	svey
渽	slox
渾	snc
渿	smfm
湀	sxty
湁	sfvo
湂	soos
湃	sjff
湄	sdjg
湅	stqm
湆	sdb
湇	sdd
湈	shfm
湉	syjo
湊	sevy
湋	szii
湌	svdk
湍	sejn
湎	sjqf
湏	sjgv
湐	smg
湑	sjld
湒	sop
湓	svdq
湔	svdn
湕	sefz
湖	sxod
湗	slld
湘	smg
湙	sdmy
湚	sjwl
湛	shel
湜	sbtl
湝	sug
湞	sygv
湟	sge
湠	sexx
湡	sbng
湢	stoq
湣	sptb
湤	sdhc
湥	snvd
湦	sbjl
湧	sdnj
湧	sddj
湨	sgyd
湩	sjtl
湪	sljx
湫	shx
湬	hxs
湭	svu
湮	scl
湯	sbts
湯	sbjs
湰	satl
湱	sfc
湲	sjfa
湳	sxny
湳	sxnx
湴	svwt
湵	sven
湶	sgs
湷	sevb
湸	sdow
湹	sjbl
湺	stom
湻	sdob
湼	sgi
湽	stsq
湽	sstq
湾	sdms
湿	sbwt
満	shte
満	shne
溁	shnm
溂	ston
溃	sqb
溄	seaf
溅	sbfx
溆	svta
溇	sxr
溈	sdjh
溉	segw
溊	spfa
溋	szjq
溌	sxtl
溌	sxth
溍	stwb
溎	smll
溏	sjeo
源	sjgm
溑	swgv
溒	slok
溓	svem
溔	sveh
溕	snfx
準	stix
溗	sjxv
溘	slgq
溙	sevs
溚	shvo
溛	snvn
溜	sgdq
溝	sfnl
溞	sadq
溟	snbv
溠	svfi
溡	sbld
溢	svvq
溣	stvh
溤	ssh
溥	stdd
溦	seta
溧	scm
溨	slmx
溩	sjzh
溪	sjwy
溫	sqvq
溬	svfg
溭	sqva
溮	sjpi
溯	svud
溰	setv
溱	sevh
溲	sgia
溳	sogv
溴	sjgd
溵	sjja
溶	snvo
溷	sqx
溸	slwm
溹	sxnm
溺	szsv
溻	sbjj
溼	stwl
溽	sjfd
溾	sgwg
溿	sqvx
滀	sdwq
滁	spvm
滂	sdnh
滃	svgj
滄	svdo
滅	sjtx
滆	stoy
滇	sxqv
滈	sdoo
滉	sbww
滊	skzx
滋	svww
滌	stim
滍	sulq
滍	suiq
滎	xxns
滏	svxv
滐	sdcm
滑	sqdh
滒	stoo
滓	sndx
滔	sjg
滕	dvys
滖	sdok
滗	skjl
滘	snvo
滙	scti
滚	sdvk
滛	sjlu
滜	sgyx
滝	sdbl
滞	shni
滟	sfrl
滠	spaa
满	shtv
滢	shnd
滣	sjfo
滤	syu
滥	snkq
滦	sdmm
滧	sdva
滨	sngv
滩	sati
滪	sdtb
滫	stid
滬	sdpl
滭	sbhf
滮	syws
滯	shwi
滯	shni
滰	sdbw
滱	snfa
滲	sggs
滳	sdno
滴	sdno
滵	snue
滶	slha
滷	syqd
滸	silx
滹	syji
滺	stiu
滻	sdjl
滼	smmd
滽	sjei
滾	sdvk
滿	shnd
漀	ldjs
漁	srh
漂	scfm
漃	snla
漄	sejl
漅	ssbm
漆	smvs
漇	ssll
漈	sxfm
漉	sjzu
漊	sotr
漋	spal
漌	shol
漍	sqtx
漎	ssvl
漏	spu
漐	lyxs
漐	lvxs
漑	sgtw
漒	szsq
漓	sdxg
演	sntv
漕	sub
漖	syza
漗	sjqu
漘	sjfd
漙	stbd
漚	scoo
漛	svys
漜	smml
漝	sjjg
漞	sjgw
漟	swnl
漠	shby
漡	slbs
漢	shov
漣	scz
漤	smmr
漥	snvl
漦	fmas
漧	sxbz
漨	safz
漩	sdhl
漪	sxjo
漫	sbqa
漬	slgv
漭	shyh
漮	sjes
漯	sqwm
漰	sedd
漱	stov
漲	szsk
漳	sdbx
漴	senm
漵	svta
漶	soou
漷	sdop
漸	scjt
漹	stlh
漺	syxx
漺	stxv
漻	sjjs
漼	seti
漽	spsi
漾	svex
漿	kdxs
潀	sqjv
潀	sqjn
潁	tsjv
潂	sevt
潃	ssad
潄	stoa
潅	slxi
潆	shnm
潇	shen
潇	shei
潈	sjqx
潉	sebu
潊	svta
潋	svta
潌	snvl
潍	swti
潎	svna
潏	sdto
潐	stih
潑	sxza
潒	srox
潒	srbx
潓	stbu
潔	sfdm
潕	slhh
潖	seel
潗	stim
潘	sjxq
潙	sjjh
潚	seik
潛	scwb
潜	sfvb
潝	svtj
潞	solo
潟	sgsh
潠	seev
潡	sdoa
潢	shdv
潣	sndx
潤	sne
潥	scx
潦	syvm
潧	svqb
潨	sjqx
潩	sqhv
潪	slyb
潫	svym
潬	soox
潭	scbx
潮	sxbd
潯	seid
潰	sqgv
潱	slnv
潲	shwd
潳	spyb
潴	sxjb
潵	shda
潶	sqh
潷	skef
潸	smmd
潹	smmm
潺	spzz
潻	shvs
潼	sdbl
潽	svwb
潾	sxdi
潿	sqzi
澀	sddl
澁	slll
澂	seta
澃	sjgs
澄	sxtv
澅	selt
澆	sllw
澇	sxxj
澈	sdga
澉	sjpa
澊	svud
澋	sbdm
澌	shet
澍	slod
澎	slos
澏	sooe
澐	sufg
澑	stnq
澑	stcq
澒	sijv
澓	ssla
澔	sgjo
澕	shtf
澖	snm
澗	snb
澘	smmb
澙	sgsh
澚	sjns
澛	srtb
澜	sntm
澝	snui
澝	snuf
澞	syoy
澟	sdqh
澠	sq
澡	soom
澢	swnq
澣	sxbf
澤	sqly
澤	sqlx
澥	srdi
澦	sdtv
澧	sutv
澨	skiv
澩	jkxs
澪	suvd
澫	shbg
澬	svrv
澭	sdwi
澮	svtb
澯	sydx
澰	svtv
澱	spha
澲	swtm
澳	sjny
澴	sqtk
澵	sdmt
澶	sdqt
澷	sbqh
澸	sjtu
澹	srji
澺	sdbu
澻	svxz
澼	spox
澽	syx
澾	slvz
澿	smmm
激	sgda
濁	sqsq
濂	sjvm
濃	sujk
濄	sqoz
濅	snea
濆	sxhv
濇	sxvo
濈	sopx
濉	sgti
濊	sljx
濋	smml
濌	jtbb
濍	shsu
濎	sgkk
濏	seej
濐	sbyb
濑	stob
濒	syjb
濓	sdjm
濔	stvx
濕	sbwh
濖	sqyb
濗	shbi
濘	snut
濙	sxxx
濚	sxxm
濛	shnx
濜	selq
濜	seiq
濝	shem
濞	sjgn
濟	sddh
濠	sdox
濡	sujn
濢	sjjx
濣	sxbx
濤	sljd
濥	sdnv
濦	sjiu
濧	swtd
濨	svwu
濩	shta
濪	sldl
濫	sgkq
濬	syng
濭	shlq
濮	stwv
濯	sjji
濰	swmi
濱	sntv
濲	slna
濳	sjlb
濴	sxxs
濵	sndv
濶	snjo
濷	sshd
濸	shvo
濹	sbll
濺	sgvx
濻	spqv
濼	swgm
濽	sfvv
濾	syqu
濿	sjhg
瀀	sjqa
瀀	sjna
瀁	svek
瀂	srhb
瀃	sgvs
瀄	skep
瀅	sxxd
瀆	slqv
瀇	sjhv
瀈	sjjc
瀉	sngh
瀊	snsq
瀋	snjq
瀌	sjzh
瀍	sjbl
瀎	shqx
瀏	sgdn
瀐	slnx
瀐	slex
瀑	sbhs
瀒	sxvo
瀒	stvo
瀓	ssea
瀔	slna
瀕	syjv
瀖	suti
瀗	snfu
瀘	syqq
瀙	sdmw
瀚	sxbj
瀛	sdld
瀜	stoq
瀝	sjhl
瀞	sldi
瀟	shek
瀠	sxnm
瀡	spxz
瀢	sqgz
瀣	sydt
瀤	sdqk
瀥	sjjo
瀦	sxyb
瀧	sdde
瀨	stov
瀩	shwv
瀪	lqss
瀫	slna
瀬	stov
瀭	scvn
瀮	summ
瀯	sxxo
瀰	szsx
瀱	sqjn
瀲	svta
瀳	shjh
瀴	sgvr
瀵	sxqv
瀶	sglo
瀷	sjjv
瀸	svvx
瀹	svth
瀺	srod
瀻	slqx
瀼	sdok
瀽	snfl
瀾	sntm
瀿	slqm
灀	sumg
灁	sngs
灂	sjqd
灃	sffv
灄	sppp
灅	sqql
灆	shgq
灇	swta
灈	sggi
灉	ssoi
灊	scwy
灋	sjzg
灌	shoi
灍	snvv
灎	sutq
灏	sbdb
灐	sxxv
灑	stnu
灒	sjlv
灓	wmis
灔	sutl
灕	sdxi
灖	sjme
灗	sqdt
灘	shoi
灙	swnh
灚	sjkw
灛	snox
灜	sdld
灝	sbdv
灞	suhd
灟	spsq
灠	sgkw
灡	shnm
灢	stok
灣	swms
灤	swmm
灥	gsgs
灦	sbwv
灧	sffl
灨	sdbv
灩	sffq
灪	smls
火	xiih
灬	hii
灭	txbm
灭	txam
灮	xw
灯	xt
灰	xxch
灱	xd
灲	xn
灳	sx
灴	xi
灵	ex
灶	xluz
灷	xh
灸	rdx
灹	xjt
灺	xc
灻	lx
灼	xsd
災	sx
灾	nxbz
灿	xeuc
炀	xzs
炁	cwh
炂	xvg
炃	vdx
炄	xjxt
炅	bxbg
炆	xdx
炇	xa
炈	xwa
炉	xdp
炊	xrv
炋	xjy
炌	xvn
炍	xjja
炎	xxby
炏	xx
炐	xf
炑	xm
炒	xmj
炓	xddx
炔	xzv
炕	xdwk
炖	xtul
炗	hx
炘	xjjt
炙	dxbz
炚	bx
炛	xtt
炜	xfji
炝	xvc
炞	xdy
炟	xbt
炠	xq
炡	xtl
炢	xmd
炣	xto
炤	xdo
炥	xzsn
炦	xxad
炧	xlc
炨	xnt
炩	xvjd
炪	xue
炫	xdwx
炫	xdws
炬	xguj
炭	exxt
炮	xse
炯	xno
炰	seh
炱	gox
炲	xgo
炳	xtnv
炴	xny
炵	xadd
炶	xyo
炷	xde
炸	xlk
点	yoh
為	djjh
炻	xc
炼	xtjv
炽	xov
炾	xow
炿	xnd
烀	xjvi
烁	xcm
烂	xve
烃	xzi
烄	xdvx
烅	xjq
烆	xsfi
烇	xve
烈	tdnh
烉	rnvx
烊	xvf
烋	tmh
烌	xtm
烍	xjlw
烎	thx
烏	jzth
烐	xns
烑	xvwv
烒	xtiv
烓	xll
烔	xnto
烕	jtxx
烖	lxx
烗	xdyv
烘	xhvh
烙	xao
烚	xvto
烛	xquz
烜	xtbt
烝	jxth
烞	xmy
烟	xqy
烠	xxd
烡	xhv
烢	xnjt
烣	xxx
烤	xys
烥	xg
烦	xjb
烧	xxtw
烨	xttx
烩	xvfg
烪	xvy
烫	szsx
烬	xpnd
热	fxdh
烮	tdnx
烯	xxxi
烰	xjz
烱	xnvo
烲	fjjx
烳	xtdd
烴	xtsi
烵	xhsd
烶	xjlz
烷	xnfw
烸	xlqs
烹	dojh
烺	xdek
烻	xjlz
烼	xx
烽	xaf
烾	xxl
烿	xnds
焀	xvvo
焁	orvx
焂	tiax
焃	xlm
焄	ejoh
焅	xjlo
焆	xod
焇	xwd
焈	dpex
焉	tlsh
焊	xbf
焋	klx
焌	xgva
焍	xvzj
焎	fjjh
焏	joah
焐	xwo
焑	xqm
焒	xoo
焓	xvjo
焔	xhib
焕	xrny
焖	xnu
焗	xpjo
焘	fxdh
焙	xdo
焚	mmx
焛	nnx
焜	xbu
焝	xctb
焞	xdoz
焟	xhb
焠	xdvx
無	lhh
焢	xnvi
焣	pah
焤	jtxx
焥	xndc
焦	tih
焧	xvgu
焨	xbd
焩	xdd
焪	xnvs
焫	xhnv
焬	xbss
焭	xxnw
焮	xjjv
焯	xybx
焰	xrg
焱	xxx
焲	xdtn
焳	xti
焴	xdgd
焵	xnve
然	dydh
焷	xgjx
焸	bbx
焹	xnvl
焺	xbjh
焻	xbb
焼	xxhw
焽	bdx
焾	xvju
焿	xjev
煀	xpue
煁	xhel
煂	xhp
煃	xyll
煄	xjtl
煅	xjia
煆	xpfa
煇	xnc
煈	xwjq
煉	xtqm
煊	xntt
煋	xbjl
煌	xge
煍	xhx
煎	vdnh
煏	xtoq
煐	xhny
煑	ybx
煒	xzii
煓	xejn
煔	xxyo
煕	geh
煖	xjfa
煗	xjny
煘	xjtx
煙	xcl
煚	bgx
煛	ggx
煜	xbd
煝	xdjg
煞	reah
煟	xqd
煠	xhlm
煡	xefz
煢	xxnx
煣	xdtm
煤	xhfm
煥	xrny
煦	bsoh
照	bdoh
煨	xqtk
煩	xjgv
煪	xvu
煫	xvx
煬	xbts
煬	xbjs
煭	stdh
煮	ybh
煯	xug
煰	xooo
煱	xqo
煲	tomx
煳	xxod
煴	xbq
煵	xxny
煵	xxnx
煶	xbtl
煷	xdow
煸	xdph
煹	xfnl
煺	xekz
煻	xjeo
煼	xsuj
煽	xdpj
煾	xqyu
煿	xtdd
熀	xbww
熁	xjjd
熂	xkzx
熃	dtjx
熄	xjgu
熅	xqvq
熆	xlgq
熇	xdoo
熈	jgeh
熉	xogv
熊	gdth
熋	gdtx
熌	xnv
熍	xnoo
熎	xjlu
熏	jtqh
熐	xnbv
熑	xvem
熒	xxnx
熓	xjzh
熔	xnvo
熕	xigv
熖	xjg
熗	xvdo
熘	xgdq
熙	geh
熚	xbhf
熛	xcfm
熜	xjqu
熝	xjzu
熞	xgal
熟	dozh
熠	xjjg
熡	xotr
熢	xafz
熣	xeti
熤	xjjd
熥	xdnz
熥	xddz
熦	xmji
熧	svvx
熨	pfmx
熩	xdpl
熪	xhdd
熫	xjhh
熬	lhah
熭	ffex
熮	xjjs
熯	xhov
熰	xcoo
熱	lvlh
熲	txjv
熳	xbqa
熴	xebu
熵	xdno
熶	xbpa
熷	xvqb
熸	xcwb
熹	lovh
熺	xloo
熻	xvtj
熼	xqhv
熽	xeik
熾	xdbx
熿	xhdv
燀	xoox
燁	xhtf
燂	xcbx
燃	xdyh
燄	rgxx
燅	lvlx
燆	xjyo
燇	xvud
燈	xxtv
燉	xdoa
燊	xxxm
燋	xtih
燌	xxhv
燍	xhet
燎	xyvm
燏	xdto
燐	xxdi
燑	xdbl
燒	xllw
燓	mxxx
燔	xjxq
燕	hokh
燕	hkoh
燖	xeid
燗	xnd
燘	xndx
燙	sbtx
燙	sbjx
燚	xxxx
燛	ggx
燜	xnu
燝	xbdm
燞	tirh
營	xxno
燠	xjny
燡	xqly
燡	xqlx
燢	jkxx
燣	xdqh
燤	xhbg
燥	xoom
燦	xydx
燧	xvxz
燨	xvex
燩	xgda
燪	xhsu
燫	xjvm
燬	xgia
燭	xqsq
燮	xixa
燯	xuvd
燰	xjna
燱	xdbu
燲	xjjv
燳	xbdh
燴	xvtb
燵	xlvz
燶	xujk
燷	xdqm
燸	xujn
燹	xxx
燺	xdom
燻	xjth
燼	xelq
燼	xeiq
燽	xljd
燾	ljih
燿	xjji
爀	xlmm
爁	xgkq
爂	jknx
爃	xxxm
爄	xjhg
爅	xqhl
爆	xbhs
爇	hlvh
爈	xyqu
爉	xsqv
爊	xjzh
爋	xjth
爌	xjhv
爍	xwgm
爎	xnym
爏	xjhl
爐	xyqq
爑	xhth
爒	dxym
爓	xnrg
爔	xvex
爕	xixx
爖	xdde
爗	xbhf
爘	xydk
爙	xdok
爚	xvth
爛	xntm
爜	xwta
爝	xjqd
爞	xqqq
爟	xhoi
爠	xggi
爡	xhbq
爢	jmmh
爣	xwnh
爤	xhnm
爥	xpsq
爦	xgkw
爧	xuov
爨	jknx
爩	xmls
爪	jiiz
爫	jii
爬	jdlp
爭	jei
爮	jse
爯	jnl
爰	jfa
爱	jnxa
爲	jjjh
爳	jjjj
爴	qtoj
爵	jqed
父	vxbf
爷	vxp
爸	vxdl
爹	vxdd
爺	vxpp
爻	xx
爼	xxqf
爽	yxxx
爽	txxv
爾	tvnx
爿	kii
牀	km
牂	kvf
牃	khlm
牄	kvdo
牅	kjei
牆	kxvo
片	kiip
版	kjja
牉	kvx
牊	kdo
牋	kxx
牌	kgjx
牍	kxjy
牎	kssu
牏	kvtn
牐	kjxg
牑	kdph
牒	khlm
牓	kdnh
牔	ktdd
牕	kjqu
牖	kdpd
牗	kjei
牘	klqv
牙	cij
牚	wnoj
牛	kian
牜	jf
牝	jft
牞	jfj
牟	gki
牠	jfc
牡	jfl
牢	nki
牣	jfdd
牤	jfdl
牥	jfdh
牦	jfjl
牧	jfam
牨	jfdw
物	jfss
牪	jfki
牫	jfx
牬	jfsj
牬	jfjj
牭	jfq
牮	tvki
牯	jfxo
牰	jfd
牱	jfto
牲	jfjl
牳	jfqs
牴	jfcd
牵	ynki
牶	vyki
牷	jfve
牸	jfnz
特	jfld
牺	jfc
牻	jfxd
牼	jfti
牽	dyni
牾	jfwo
牿	jfjo
犀	pski
犁	hnki
犂	hsji
犃	jfdo
犄	jfyo
犅	jfne
犆	jfxe
犇	kiki
犇	kiji
犈	jfvc
犉	jfdz
犊	jfxy
犋	jfqv
犌	jfpa
犍	jfez
犎	llxi
犏	jfdh
犐	jfhx
犑	jfgd
犒	jfdo
犓	jfsj
犔	jfkx
犕	jfhi
犕	jfhf
犖	xxni
犗	jfno
犘	jmmi
犙	jfgs
犚	pfmi
犛	fmai
犜	jfda
犝	jfdl
犞	jfjo
犟	zsoi
犠	jfvx
犡	jfjg
犢	jflv
犣	jfsv
犤	jfqt
犥	jfjh
犦	jfbs
犧	jfvx
犨	titi
犩	hrgi
犪	jfva
犫	tiii
犬	ydaq
犬	ydac
犭	xj
犮	xad
犯	xjc
犰	xjx
犱	xjxd
犲	xjxj
犳	xjsd
犴	xjf
犵	xjlz
状	kyd
犷	xjj
犸	xjst
犹	xjxd
犺	xjdw
犻	xjti
犼	xjzl
犽	xjcj
犾	xjyd
犿	xjdy
狀	kyd
狁	xjgw
狂	xje
狃	xjjt
狄	xjx
狅	xjjl
狆	xjoi
狇	xjm
狈	xjb
狉	xjjt
狊	gyd
狋	xjfm
狌	xjjl
狍	xjse
狎	xjq
狏	xjlc
狐	xjjn
狑	xjvd
狒	xjzn
狓	xjja
狔	xjpt
狕	xjwj
狖	xjnv
狗	xjso
狘	xjcx
狙	xjqf
狚	xjbt
狛	xjg
狜	xjxo
狝	xjrm
狞	xjnt
狟	xjtt
狠	xjek
狡	xjdx
狢	xjao
狣	xjvv
狤	xjlo
狥	xjsb
狦	xjnn
狧	xjjo
狨	xjtx
狩	xjnd
狪	xjno
狫	xjyt
独	xjq
狭	xjtv
狮	xjni
狯	xjvg
狰	xjri
狱	xjid
狲	xjzm
狳	xjvm
狴	xjul
狵	xjxd
狶	xjxi
狷	xjod
狸	xjbl
狹	xjtv
狺	xji
狻	xjga
狼	xjdk
狽	xjgv
狾	xjft
狿	xjjz
猀	xjsj
猁	xjhn
猂	xjbf
猃	xjvw
猄	xjdm
猅	xjne
猅	xjee
猆	need
猆	ened
猇	xjyw
猈	xjgx
猉	xjhv
猊	xjgw
猋	ydyd
猌	xvvd
猌	tvvd
猍	xjxv
猍	xjtm
猎	xjhb
猏	xjdd
猐	xjvl
猑	xjbu
猒	bdyd
猓	xjbm
猔	xjnm
猕	xjzm
猖	xjbb
猗	xjyo
猘	xjkn
猙	xjji
猚	xjti
猛	xjzq
猜	xjld
猝	xjdx
猞	xjvo
猟	xjwf
猠	xjuv
猡	xjqd
猢	xjxd
猣	xjxa
猤	xjxy
猥	xjqk
猦	xjwq
猧	xjqo
猨	xjja
猩	xjbl
猪	xjyb
猫	xjhq
猬	xjqd
猭	xjlx
献	xnyd
献	xnvd
猯	xjen
猰	xjfy
猱	xjdm
猲	xjbl
猳	xjpa
猴	xjty
猵	xjdh
猶	xjvu
猷	vuyd
猸	xjdg
猹	xjmt
猺	xjju
猻	xjzm
猼	xjtd
猽	xjnv
猾	xjqd
猿	xjlk
獀	xjga
獁	xjsh
獂	xjjm
獃	etod
獄	xjid
獅	xjji
獆	xjgx
獇	xjvg
獈	xjvq
獉	xjeh
獊	xjvo
獋	xjjx
獌	xjba
獍	xjdw
獎	kdxd
獏	xjhy
獐	xjdx
獑	xjct
獒	lhad
獓	xjla
獔	xjgx
獕	xjei
獖	xjxv
獗	xjjv
獘	vnmd
獙	xjva
獚	xjhv
獛	xjwv
獜	xjxi
獝	xjdo
獞	xjdl
獟	xjlw
獠	xjym
獡	xjgh
獢	xjjo
獣	wqtd
獤	xjda
獥	xjga
獦	xjhl
獧	xjqk
獨	xjqq
獩	xjlx
獪	xjvb
獫	xjvv
獬	xjri
獭	xjtb
獮	xjtx
獯	xjjh
獰	xjnt
獱	xjnv
獲	xjha
獳	xjun
獴	xjhx
獵	xjsv
獶	xjja
獷	xjjv
獸	ooqd
獹	xjyq
獺	xjtv
獻	ytod
獼	xjzx
獽	xjdk
獾	xjhi
獿	xjta
獿	xjja
玀	xjqi
玁	xjoa
玂	xjht
玃	xjga
玄	dwbx
玄	dwbs
玅	dwmj
玆	dwdw
率	dwxx
率	dvwx
玈	dwlk
玉	eday
玊	ed
王	eiiw
玌	el
玍	ll
玎	et
玏	ej
玐	ev
玑	ew
玒	ei
玓	esd
玔	em
玕	ef
玖	ern
玗	ef
玘	ezl
玙	es
玚	ezs
玛	est
玜	evg
玝	elx
玞	efv
玟	edx
玠	evn
玡	ecij
玢	evd
玣	edy
玤	ef
玥	ed
玦	ezv
玧	egw
玨	ee
玩	efw
玪	evj
玫	eaum
玬	end
玭	eu
玮	efji
环	ejyh
现	enws
玱	evc
玲	evjd
玳	etv
玴	ehl
玵	ehf
玶	etvi
玷	eyo
玸	ese
玹	edw
玺	rmed
玻	eja
玼	elt
玽	eso
玾	eq
玿	edo
珀	egup
珁	etld
珂	etok
珃	enl
珄	ejl
珅	ebi
珆	ego
珇	eqf
珈	ejoz
珉	eptv
珊	ennt
珋	ecjp
珌	euj
珍	evsz
珎	erm
珏	eed
珐	elg
珑	extd
珒	eef
珓	edvx
珔	exiz
珕	ejjj
珖	eww
珗	ejlw
珘	ens
珙	ehv
珚	eqy
珛	exd
珜	evf
珝	ejj
珞	eao
珟	ewtd
珠	ekm
珡	eev
珢	eek
珣	esb
珤	elxu
珥	ep
珦	ejno
珧	evwv
珨	evto
珩	esfi
珪	ell
珫	edgw
珬	ejtx
班	eye
珮	ewti
珯	eyt
珰	ewe
珱	ewr
珲	enc
珳	edxs
珴	ejfx
珵	eoe
珶	evzj
珷	eflv
珸	ewo
珹	ejjx
珺	eejo
珻	elqs
珼	egv
珽	ejlz
現	egw
珿	eol
琀	evjo
琁	eljl
琂	ei
球	exxd
琄	eod
琅	edek
理	ebl
琇	ehzj
琈	ejz
琉	edgm
琊	ecip
琋	exxi
琌	eevj
琍	ehn
琎	efnz
琏	ecz
琐	ewb
琑	ewd
琒	eaf
琓	enfw
琔	entl
琕	egjx
琖	exx
琗	edvx
琘	ectb
琙	etox
琚	epxo
琛	envm
琜	exvv
琜	etvm
琝	ebdx
琞	bded
琟	eti
琠	euv
琡	elma
琢	exdz
琣	edo
琤	erei
琥	eyw
琦	eyto
琧	txtd
琨	ebu
琩	ebb
琪	ehev
琫	eevf
琬	endc
琭	ees
琮	enfm
琯	enpz
琰	exxy
琱	enlo
琲	enee
琲	eene
琳	emm
琴	eevj
琵	eeu
琶	eedl
琷	evfl
琸	eybx
琹	eem
琺	eslg
琻	ev
琼	edom
琽	eyb
琾	eqvn
琿	enc
瑀	ejog
瑁	ebg
瑂	edjg
瑃	eevb
瑄	entt
瑅	ebtl
瑆	ebjl
瑇	elqs
瑈	edtm
瑉	eptb
瑊	ejtx
瑋	ezii
瑌	ejny
瑍	erny
瑎	eug
瑏	envj
瑐	evdn
瑑	eljx
瑒	ebts
瑒	ebjs
瑓	etqm
瑔	egs
瑕	epfa
瑖	ejia
瑗	ejfa
瑘	epp
瑙	esjx
瑚	exod
瑛	ehny
瑜	evtn
瑝	ege
瑞	eejn
瑟	eeuj
瑠	egdq
瑡	ejpi
瑢	envo
瑣	ewgv
瑤	edlu
瑥	ebq
瑦	ejzh
瑧	eevh
瑨	etwb
瑩	xxnd
瑪	esh
瑫	ejg
瑬	sdgd
瑭	ejeo
瑮	ecm
瑯	edep
瑰	egwg
瑱	exqv
瑲	evdo
瑳	evfi
瑴	lnta
瑵	eadq
瑶	ejlu
瑷	ejna
瑸	engv
瑹	ehvm
瑺	ewni
瑻	eqxv
瑼	etbd
瑽	esvl
瑾	ehol
瑿	clyd
璀	eeti
璁	ejqu
璂	ehel
璃	edxg
璄	edbw
璅	esbm
璆	ejjs
璇	edhl
璈	elha
璉	ecz
璊	ehnd
璋	edbx
璌	entv
璍	ehtf
璎	ebbr
璏	eljt
璐	eolo
璑	elhh
璒	extv
璓	ehhj
璔	evqb
璕	eeid
璖	esgm
璗	sbtd
璗	sbjd
璘	exdi
璙	eyvm
璚	edto
璛	eeik
璜	ehdv
璝	eqgv
璞	ewtv
璟	ebdm
璠	ejxq
璡	etiz
璢	etnq
璢	etcq
璣	ewwx
璤	etbu
璥	ehsa
璦	ejna
璧	podd
璨	eydx
璩	eyx
璪	eoom
璫	ewnq
璬	egda
璭	encz
璮	edqt
璯	evtb
環	eqtk
璱	eeej
璲	evxz
璳	ekmv
璴	emml
璵	ejkv
璶	eelq
璶	eeiq
璷	etda
璸	entv
璹	eljd
璺	jknd
璻	ejjx
璼	egkq
璽	tvnd
璾	eddh
璿	eyng
瓀	eujn
瓁	ehta
瓂	ehlq
瓃	eqqq
瓄	elqv
瓅	ewgm
瓆	ejjv
瓇	ejqa
瓇	ejna
瓈	ehss
瓉	efvv
瓊	erna
瓋	ednz
瓌	edqk
瓍	epxz
瓎	etov
瓏	edde
瓐	eyqq
瓑	ejhl
瓒	ejlb
瓓	entm
瓔	egvr
瓕	zstd
瓖	edok
瓗	eeto
瓘	ehoi
瓙	eljh
瓚	ejlv
瓛	eytd
瓜	jjgn
瓝	jjgd
瓞	jjgv
瓟	jjge
瓠	yfsn
瓡	lyjn
瓡	lvxn
瓢	cfmn
瓣	dxjx
瓤	doon
瓥	jjgq
瓦	tlzd
瓧	tlzx
瓨	itld
瓩	tlzx
瓪	tlza
瓫	vdtd
瓬	dhtd
瓭	pltd
瓮	vgtd
瓯	cxtd
瓰	tlzd
瓱	tlzl
瓲	tlzl
瓳	xotd
瓴	vjdd
瓵	gotd
瓶	vhtd
瓷	vrvd
瓸	tlzb
瓹	odtd
瓺	ktld
瓻	xxnd
瓼	tlzl
瓽	wnod
瓾	hrtd
瓿	dotd
甀	jxhd
甀	jthd
甁	jfjd
甂	dpnd
甃	hxtd
甄	cltd
甅	tlzl
甆	vwwd
甇	xxnd
甈	jgmd
甉	vemd
甊	otod
甋	dnxd
甌	cood
甍	hqnd
甎	tbgd
甏	lovd
甐	xdcd
甑	vqbd
甒	lhhd
甓	podd
甔	rjvd
甕	dwjd
甖	gvgd
甗	ytod
甘	hfag
甙	thfv
甚	hevl
甛	hfjo
甜	jxof
甝	ywhf
甞	wnof
生	jlas
甠	bjl
甡	jljl
產	dxjl
産	djjl
甤	xjl
甥	jlqj
甦	tbxl
甧	jljd
用	nfcy
用	dicy
用	diay
甩	nfl
甩	dlas
甪	jnf
甪	jdi
甫	tdid
甬	dnf
甬	ddi
甭	jynf
甭	jydi
甮	ssnf
甮	ssdi
甯	nunf
甯	nudi
田	qiit
由	diiy
甲	qiij
申	bi
甴	dii
电	blad
甶	jq
男	qj
甸	sqcd
甹	dts
町	qt
画	tqu
甼	qt
甽	qm
甾	sqbz
甿	qdl
畀	qtn
畁	dtn
畂	qrn
畃	bisd
畄	wq
畅	bizs
畆	dqg
畇	qsv
畈	qjja
畉	qfv
畊	qfn
畋	qa
界	qvnj
畍	qvn
畎	qyd
畏	qtk
畐	toq
畑	xq
畒	dqv
畓	sq
畔	qvx
畕	qq
畖	qjjn
畗	doq
畘	qnl
留	gdq
畚	gyq
畛	qvs
畜	dwq
畝	dqrn
畞	xqrn
畟	qva
畠	gq
畡	qdyv
畢	bhf
畣	vtoq
畤	qlxd
略	qao
畦	qllq
畧	qao
畨	xq
畩	qdk
番	jxq
畫	elqt
畬	vtmq
畭	qvtm
畮	qlqs
畯	qgva
異	qhv
畱	tncq
畱	tciq
畲	vfmq
畳	qnqf
畴	qfxd
畵	elqu
當	wnoq
畷	qaaa
畸	qyto
畹	qndc
畺	tqtt
畻	qvyl
畼	qbts
畼	qbjs
畽	qjtl
畾	qqq
畿	wwtx
疀	sqtl
疁	qjjs
疂	qxnf
疃	qdbl
疄	qxdi
疅	qtqt
疆	zslt
疇	qljd
疈	toqq
疉	qqqt
疊	qqqf
疋	jlbp
疌	tel
疍	jlbt
疎	jltm
疏	jldm
疐	xnql
疑	tlyl
疒	jii
疓	jzj
疔	jtcd
疕	jt
疖	jpcj
疗	jjcl
疘	ji
疙	jlzg
疚	jrn
疛	jxd
疜	jtd
疝	jecs
疞	jfs
疟	jct
疠	jth
疡	jzs
疢	jx
疣	jxld
疤	jdlb
疥	jvn
疦	jzv
疧	jctv
疨	jcij
疩	jxx
疪	ju
疫	jwa
疬	jjj
疭	jvv
疮	jvc
疯	jwx
疰	jde
疱	jsep
疲	jjap
疳	jhf
疴	jtok
疵	jlt
疶	jhl
疷	jctd
疸	jbt
疹	jvs
疺	jjdz
疻	jov
疼	jadd
疽	jqf
疾	jly
疿	jzsn
痀	jso
痁	jyo
痂	jjo
痃	jdw
痄	jlk
病	jtnv
痆	jpt
症	jtl
痈	jnf
痈	jdi
痉	jzi
痊	jve
痋	jq
痌	jnto
痍	jtzv
痎	jdyv
痏	jxd
痐	jqo
痑	jdd
痒	jvfy
痓	jtgl
痔	jlxd
痕	jek
痖	jtwt
痗	jlqs
痘	jtov
痙	jtsi
痚	jyz
痛	jdnf
痛	jddi
痜	jhw
痝	jxld
痞	jjyo
痟	jwd
痠	jgva
痡	jtdd
痢	jhn
痣	jlu
痤	jvvl
痥	jvow
痦	jwo
痧	jsmj
痨	jhnj
痩	jbia
痪	jrny
痫	jnm
痬	jbss
痭	jdd
痮	jk
痯	jnpz
痰	jxx
痱	jene
痲	jmxw
痳	jmm
痴	jlyo
痵	jhz
痶	juv
痷	jybl
痸	jknn
痹	jqtn
痺	jgjx
痻	jctb
痼	jqxo
痽	jti
痾	jpto
痿	jhr
瘀	jdhd
瘁	jdvx
瘂	jtxt
瘃	jxd
瘄	jhb
瘅	jvbx
瘆	jgys
瘇	jjtl
瘈	jfdy
瘉	jvtn
瘊	jtzy
瘋	jwjq
瘌	jton
瘍	jbts
瘍	jbjs
瘎	jhel
瘏	jyb
瘐	jgv
瘑	jqo
瘒	jnc
瘓	jrny
瘔	jhxo
瘕	jpfa
瘖	jdb
瘗	jtvl
瘘	jxr
瘙	jadq
瘚	jvuv
瘛	jfdu
瘜	jjgu
瘝	jqs
瘝	jqiv
瘝	jqid
瘞	jtvl
瘟	jbq
瘠	jxvd
瘡	jvdo
瘢	jnsa
瘣	jgwg
瘤	jgdq
瘥	jvfi
瘦	jgia
瘧	jyct
瘨	jxqv
瘩	jhvo
瘪	jjgt
瘫	jati
瘬	jzsk
瘭	jcfm
瘮	jggs
瘯	jdhy
瘰	jqwm
瘱	jtvu
瘲	jsvl
瘳	jjjs
瘴	jdbx
瘵	jxfm
瘶	jtov
瘷	jtoa
瘸	jjov
瘹	jvsd
瘺	jpu
瘻	jotr
瘼	jhby
瘽	jhol
瘾	jpru
瘿	jbbr
癀	jhdv
癁	jsla
療	jyvm
癃	jpal
癄	jtih
癅	jtnq
癅	jtcq
癆	jxxj
癇	jnd
癈	jxza
癉	joox
癊	jpvg
癋	jtxu
癌	jooe
癍	jede
癎	jnb
癏	jqtk
癐	jvtb
癑	jujk
癒	jvtu
癓	jsea
癔	jdbu
癕	jdwi
癖	jpox
癗	juq
癘	jhbg
癙	jglv
癚	jrji
癛	jdqh
癜	jpha
癝	jdqm
癞	jtob
癟	jjgh
癠	jddh
癡	jtll
癢	jvek
癣	jrtf
癤	jkep
癥	jsea
癦	jqhl
癧	jjhl
癨	juti
癩	jtov
癪	jhlv
癫	jxqb
癬	jrhf
癭	jgvr
癮	jpju
癯	jggi
癰	jsoi
癱	jhoi
癲	jxqv
癳	jqqm
癴	jwmf
癵	jwmv
癶	xii
癷	xf
癸	xty
癹	xwa
発	xtxl
発	xth
登	xtov
發	xzsa
白	giib
百	jbbb
癿	gl
皀	gt
皁	gx
皂	gtbz
皃	gw
的	gsd
皅	gdl
皆	ug
皇	gebh
皈	gjja
皉	glt
皊	gvjd
皋	gyx
皌	gtm
皍	gtlp
皎	gdvx
皏	gvh
皐	gxx
皑	gezl
皒	gjfx
皓	gjlo
皔	gbf
皕	jbjb
皖	gnfw
皗	gnlo
皘	gld
皙	mjjg
皚	getv
皛	ggg
皜	gdoo
皝	geww
皞	ggyx
皟	glgv
皠	geti
皡	ggxx
皢	gllw
皣	ghtf
皤	gjxq
皥	gjgx
皦	ggda
皧	gjna
皨	gggl
皩	gebw
皪	gwgm
皫	gjzh
皬	guti
皭	gjqd
皮	ja
皯	jaf
皰	jase
皱	reja
皲	ncja
皳	xxda
皴	gvaa
皵	hbja
皶	mbta
皷	lova
皸	ncja
皹	janc
皺	suja
皻	yqfa
皼	lnta
皽	dqoa
皾	lqga
皿	qiim
盀	yq
盁	zjq
盂	fqby
盃	jyq
盄	zsiq
盅	oiq
盆	vdq
盇	ydq
盈	zjaq
盉	hq
益	vvq
盋	xadq
盌	dcq
盍	lgq
盎	nyq
盏	fxq
盐	lyq
监	nkq
盒	vtoq
盓	sfq
盔	xxq
盕	swdq
盖	veq
盗	vrvq
盘	nsq
盙	tdiq
盚	xxdq
盛	jjxq
盜	srvq
盝	esq
盞	xxq
盟	bdq
盠	ljtq
盡	elhq
盡	eitq
盢	qydq
監	gkq
盤	nswq
盥	jksq
盦	vjuq
盧	yqq
盨	sjgq
盩	lyaq
盩	lvxq
盪	sbtq
盪	sbjq
盫	vtoq
盬	glxq
盭	wlyq
盭	wlvq
目	giim
盯	gtud
盰	gf
盱	gf
盲	dlg
盳	gdl
直	xqe
盵	glz
盶	gfw
盷	gsv
相	mgux
相	mgus
盹	gtul
盺	gjjt
盻	gvts
盼	gvd
盽	gf
盾	jjxg
盿	gdx
眀	gd
省	mjg
眂	gctv
眃	gfg
眄	gtlj
眅	gjja
眆	gdh
眇	gmj
眈	gpl
眉	djg
眊	gjfl
看	jfg
県	glm
眍	gcx
眎	gfm
眏	gny
眐	gtl
眑	gwj
眒	gbi
眓	gcx
眔	qs
眔	qivv
眕	gvs
眖	gow
眗	gso
眘	yvg
眙	ggo
眚	jlg
眛	gfm
眜	gtm
眝	gnt
眞	tglv
真	xqev
眠	gptv
眡	gctd
眢	dcg
眣	gkv
眤	gpt
眥	ltg
眦	glt
眧	gdo
眨	gjdz
眩	gdw
眪	gtnv
眫	gvx
眬	gxtd
眭	gll
眮	gnto
眯	gxum
眰	gtgl
眱	gtzv
眲	gp
眳	gdo
眴	gsb
眵	gdd
眶	gce
眷	vyg
眸	ggki
眹	gvy
眺	gvwv
眻	gvf
眼	gek
眽	gjjk
眾	qtvv
眾	qjiv
眾	qjin
眿	gdjx
着	vfgz
睁	grei
睂	vvig
睃	ggva
睄	gwd
睅	gbf
睆	gnfw
睇	gvzj
睈	goe
睉	gvvl
睊	god
睋	gjfx
睌	grow
睍	ggw
睎	gxxi
睏	gqm
睐	gtx
睑	gvtw
睒	gxx
睓	guv
睔	gvth
睕	gndc
睖	glva
睗	gbss
睘	qtok
睙	gdpd
睚	gjll
睛	gld
睜	gjei
睝	hsjg
睞	gxvv
睞	gtvm
睟	gdvx
睠	gvyc
睡	gjxf
睡	gjtl
睢	gti
督	lmag
睤	gqtn
睥	ggjx
睦	glvl
睧	gctb
睨	ggw
睩	ges
睪	qly
睪	qlvx
睫	gtel
睬	gjm
睭	gnlo
睮	gvtn
睯	ptvg
睰	ghxo
睱	gpfa
睲	gbjl
睳	gyll
睴	gnc
睵	glox
睶	gevb
睷	gefz
睸	gdjg
睹	gyb
睺	gtzy
睻	gntt
睼	gbtl
睽	gxty
睾	jqly
睾	jqlx
睿	yntg
瞀	dtjg
瞁	ggyd
瞂	jjxd
瞃	gjjg
瞄	ghq
瞅	ghx
瞆	gqb
瞇	gxz
瞈	gvgj
瞉	lnta
瞊	gjeo
瞋	gxqv
瞌	glgq
瞍	ggia
瞎	gnfo
瞏	qlok
瞐	ggg
瞑	gnbv
瞒	ghtv
瞓	gim
瞔	glgv
瞕	gdbx
瞖	clyg
瞗	ggh
瞘	gcoo
瞙	ghby
瞚	gntv
瞛	gsvl
瞜	gotr
瞝	gdxg
瞞	ghnd
瞟	gcfm
瞠	gwnl
瞡	gfvw
瞢	hqng
瞣	goou
瞤	gne
瞥	vnmg
瞦	gloo
瞧	gtih
瞨	gwtv
瞩	gpjg
瞪	gxtv
瞫	gcbx
瞬	gjni
瞭	gyvm
瞮	gdga
瞯	gnd
瞰	gjpa
瞱	ghtf
瞲	gdto
瞳	gdbl
瞴	glhh
瞵	gxdi
瞶	gqgv
瞷	gnb
瞸	ghhm
瞹	gjna
瞺	gvtb
瞻	grji
瞼	gvtv
瞽	lovg
瞾	ggni
瞿	ggti
矀	gsea
矁	ghxu
矂	goom
矃	gnut
矄	gjth
矅	gjji
矆	ghta
矇	ghnx
矈	ggnh
矉	gntv
矊	gwmi
矋	gjhg
矌	gjhv
矍	ggta
矎	grna
矏	gjgh
矐	guti
矑	gyqq
矒	ghqg
矓	gdde
矔	ghoi
矕	wmig
矖	gtnu
矗	xqee
矘	gwnh
矙	gnja
矚	gpsq
矛	dtj
矜	dtjj
矝	dtjd
矞	dtjo
矟	dtjd
矠	dtjb
矡	dtja
矢	lybs
矣	gly
矤	zsly
知	lyoz
矦	rjly
矧	lyzi
矨	lyjy
矩	lyg
矪	lyns
矫	lyjn
矬	lyvl
短	lytv
矮	lyhr
矯	lyjo
矰	lyvb
矱	lyha
矲	lyqt
石	ciis
矴	ct
矵	cn
矶	cwuj
矷	cz
矸	cfug
矹	ctw
矺	cjt
矻	clz
矼	ci
矽	cdux
矾	cwd
矿	cjuk
砀	czs
码	cst
砂	cmj
砃	cnd
砄	czv
砅	cs
砆	cfv
砇	cdx
砈	cjc
砉	fcbh
砊	cdw
砋	cl
砌	ctd
砍	crvk
砎	cvn
砏	cvd
砐	cjzn
砑	ccij
砒	cu
砓	cwa
研	cth
砕	cxx
砖	cfsd
砗	ccuc
砘	ctul
砙	ctld
砚	cnw
砛	cvj
砜	cwx
砝	clg
砞	ctm
砟	clk
砠	cqf
砡	ced
砢	cto
砣	cnt
砤	clc
砥	cctd
砦	ltc
砧	cyo
砨	cdpz
砩	czsn
砪	cqs
砫	cde
砬	cdul
砭	cjdz
砮	rac
砯	cds
砰	ctvi
砱	cvjd
砲	cse
砳	cc
破	cja
砵	cmt
砶	cg
砷	cbi
砸	ccni
砹	chx
砺	cjth
砻	xtdc
砼	cvi
砽	cnf
砽	cdi
砾	ccm
砿	cjg
础	cue
硁	czi
硂	cve
硃	ckm
硄	cww
硅	cll
硆	cvto
硇	cjqx
硈	clo
硉	cef
硊	crjc
硋	cdyv
硌	caog
硍	cek
硎	cthn
硏	cff
硐	cnto
硑	cvh
硒	ccux
硓	cyt
硔	chv
硕	cjb
硖	ctvv
硗	cxtw
硘	cqo
硙	cezl
硚	cjyn
硛	cdm
硜	ctsi
硝	cwdx
硝	cwds
硞	cjlo
硟	cjlz
硠	cdek
硡	cnxg
硢	cvtm
硣	cyz
硤	cyvv
硤	ctvv
硥	cxld
硦	ceh
硧	cdnf
硧	cddi
硨	cc
硩	fjjc
硪	cjfx
硫	cdgm
硬	ctbx
硭	chdl
确	cruq
确	cruc
硯	cgw
硰	smjc
硱	cqm
硲	cvvo
硳	clm
硴	chtt
硵	cyqx
硶	cevj
硷	cvtw
硸	cejf
硹	cmvg
硺	cxd
硻	gac
硼	cdd
硽	cybl
硾	cjxf
硾	cjtl
硿	cnvi
碀	crei
碁	hevc
碂	cnfm
碃	cld
碄	cmm
碅	cqh
碆	sjac
碇	cntl
碈	cctb
碉	cnlo
碊	cxx
碋	ceto
碌	ces
碍	cbtd
碎	cdvx
碏	chb
碐	clva
碑	cgjx
碒	cv
碓	cti
碔	cflv
碕	cyto
碖	cvth
碗	cndc
碘	cuv
碙	cnve
碚	cdo
碛	clb
碜	cgys
碝	cjny
碞	oooc
碟	chlm
碠	cdot
碡	clqs
碢	cqo
碣	cbsl
碤	chny
碥	cdph
碦	cnao
碧	egc
碨	cqtk
碩	cjgv
碪	chel
碫	cjia
碬	cpfa
碭	cbts
碭	cbjs
碮	cbtl
碯	csjx
碰	cvwt
碱	cjtx
碲	cdni
碳	cexx
碴	cmbt
碵	cygv
碶	cfdy
碷	cjjg
碸	cwjq
碹	cntt
確	cpii
碻	cdoo
碼	csh
碽	cigv
碾	cphk
碿	cpwd
磀	cvuz
磁	cvww
磂	cgdq
磃	cjjw
磄	cjeo
磅	cdnh
磆	cqd
磇	cjqu
磈	cgwg
磉	caam
磊	ccc
磋	cvfi
磌	cxqv
磍	cnfo
磎	cjwy
磏	cvem
磐	nswc
磑	cetv
磒	cogv
磓	cjpz
磔	cdcm
磕	clgq
磖	cjjg
磗	ctdd
磘	cjlu
磙	cdvk
磚	ctbd
磛	ccjc
磜	cxfm
磝	clha
磞	cedd
磟	cjjs
磠	cyqd
磡	chej
磢	cyxx
磢	ctxv
磣	cggs
磤	cjja
磤	cjea
磥	cqwm
磦	ccfm
磧	clgv
磨	jmmc
磩	cjlx
磪	ceti
磫	csvl
磬	ldjc
磭	cjfd
磮	cevh
磯	cwwx
磰	cvfo
磱	cxxj
磲	csgm
磳	cvqb
磴	cxtv
磵	cnb
磶	cgsh
磷	cxdi
磸	cvuy
磹	ccbx
磺	chdv
磻	cjxq
磼	ctim
磽	cllw
磾	coox
磿	jhhc
礀	cnd
礁	ctih
礂	cloo
礃	cwnf
礄	cjyo
礅	cdoa
礆	cvtv
礇	cjny
礈	cvxz
礉	cgda
礊	cuwc
礋	cqly
礋	cqlx
礌	cuq
礍	chbl
礎	cmml
礏	cwtm
礐	jkxc
礑	cwnq
礒	cvex
礓	ctqt
礔	cpox
礕	podc
礖	cjkv
礗	cntv
礘	cbwh
礙	ctll
礚	chlq
礛	cgkq
礜	jksc
礝	cujn
礞	chnx
礟	cshx
礠	cvwu
礡	chtd
礢	cvek
礣	chqx
礤	chxm
礥	cgav
礦	cjhv
礧	cqqq
礨	qqqc
礩	cjjv
礪	cjhg
礫	cwgm
礬	mxxc
礭	cuti
礮	cshx
礯	cxxm
礰	cjhl
礱	ddtc
礱	ddsc
礲	cdde
礳	cjmc
礴	chsd
礵	cumg
礶	choi
礷	chgq
礸	cjlv
礹	cooa
示	fmbs
礻	jy
礼	jyll
礽	jyzj
社	jyls
礿	jysd
祀	jye
祁	jyp
祂	jyc
祃	jyst
祄	jyvn
祅	jyjy
祆	jyty
祇	jycv
祈	jyjt
祉	jylz
祊	jydh
祋	jywa
祌	jyoi
祍	jyjl
祎	jyfi
祏	jyc
祐	jyxo
祑	jykv
祒	jydo
祓	jyxd
祔	jytd
祕	jyuj
祖	jyqf
祗	jycd
祘	fmfm
祙	jyfm
祚	jylk
祛	jylg
祜	jyxo
祝	jyow
神	jybi
祟	uefm
祠	jyjo
祡	ltfm
祢	jyrm
祣	jylk
祤	jyjj
祥	jyvf
祦	jyoy
祧	jyvv
票	cfm
祩	jykm
祪	jyrc
祫	jyvo
祬	jytl
祭	xfm
祮	jylo
祯	jyyb
祰	jyjo
祱	jyvw
祲	jyea
祳	jyjk
祴	jytx
祵	jyqm
祶	jyvj
祷	jyfd
祸	jyov
祹	jysu
祺	jyhv
祻	jyqo
祼	jybm
祽	jydx
祾	jyla
祿	jylx
禀	dqom
禁	mmfm
禂	jyno
禃	jyxe
禄	jyes
禅	jyvx
禆	jygx
禇	jyyb
禈	jync
禉	jyvu
禊	jyfy
禋	jycl
禌	jyvw
禍	jyqo
禎	jyyv
福	jytq
禐	jyja
禑	jybg
禒	jylx
禓	jybs
禔	jybl
禕	jyzi
禖	jyhm
禗	jyqu
禘	jydi
禙	jykd
禚	jyvh
禛	jyxv
禜	xxnm
禝	jyqa
禞	jydo
禟	jyjo
禠	jyjw
禡	jysh
禢	jybj
禣	jytd
禤	jyqj
禥	jyhl
禦	slxm
禦	sltm
禧	jylo
禨	jywx
禩	jyqv
禪	jyox
禫	jycx
禬	jyvb
禭	jyvz
禮	jyuv
禯	jyuk
禰	jytx
禱	jyld
禲	jyjg
禳	jydk
禴	jyvh
禵	jybv
禶	jyjv
禷	jyxv
禸	ng
禹	jong
禺	bng
离	dxug
禼	yqxg
禽	vdxg
禾	hiih
禿	hw
秀	hzjx
秀	hzjs
私	hgus
秂	hv
秃	hwbt
秄	hz
秅	hjt
秆	hfug
秇	hxd
秈	he
秉	jtem
秊	hjx
秋	hxuq
秋	hxuc
秌	xh
种	hoi
秎	hvd
秏	hjfl
秐	hfg
科	hddx
秒	hmj
秓	hxa
秔	hdw
秕	hu
秖	hctv
秗	hjy
秘	huj
秙	hxo
秚	hvx
秛	hja
秜	hpt
秝	hh
秞	hd
租	hqfz
秠	hjyt
秡	hxad
秢	hvjd
秣	htm
秤	htvi
秥	hyo
秦	evh
秧	hnyy
秨	hlk
秩	hkv
秪	hctd
秫	hmd
秬	hg
秭	hsij
秭	hjsj
秮	hgo
积	hov
称	hrm
秱	hnto
秲	hlxd
秳	hjxo
秴	hvto
秵	hqy
秶	vrvh
秷	htgl
秸	hlo
秹	htjl
秺	hnjt
移	hdd
秼	hkm
秽	hed
秾	hpk
秿	htdd
稀	hxxi
稁	donh
稂	hdek
稃	hjz
稄	hgva
稅	hvow
稆	hoo
稇	hqm
稈	hbf
稉	htbx
稊	hvzj
程	hoe
稌	hvtm
稍	hwd
税	hvow
稏	htxt
稐	hvth
稑	hlvl
稒	hqxo
稓	hhb
稔	hvju
稕	hdoz
稖	hdo
稗	hgjx
稘	hhev
稙	hxqe
稚	htiz
稛	hqh
稜	hlva
稝	hdd
稞	hbm
稟	dqoh
稠	hnlo
稡	hdvx
稢	htox
稣	rths
稤	hdom
稥	hhb
稦	hzii
稧	hfdy
稨	hdph
稩	hqd
稪	hlba
稫	htoq
稬	hjny
稭	hug
種	hjtl
稯	hxua
稰	hjld
稱	hjnl
稲	hjib
稳	hreu
稴	hvem
稵	hvww
稶	htod
稷	hqva
稸	hdwq
稹	hxqv
稺	hpdx
稻	hjg
稼	hnxj
稽	hxlb
稾	donh
稿	hdoo
穀	lnta
穁	hhp
穂	htdu
穂	htbu
穃	hnvo
穄	hxfm
穅	hjes
穆	hgms
穇	hggs
穈	jmmh
穉	hpsi
穊	hegw
穋	hjjs
穌	rhh
積	hlgv
穎	thjv
穏	hjeu
穐	hrbl
穑	hxvo
穒	hgh
穓	hqhv
穔	hhdv
穕	htim
穖	hwwx
穗	htbu
穘	hllw
穙	hwtv
穚	hjyo
穛	htih
穜	hdbl
穝	hbpa
穞	hrtb
穟	hvxz
穠	hujk
穡	hxvo
穢	hljx
穣	hdvk
穤	hujn
穥	hjkv
穦	hntv
穧	hddh
穨	hwqv
穩	hjiu
穪	htvx
穫	hhta
穬	hjhv
穭	hrhb
穮	hjzh
穯	hxoo
穰	hdok
穱	hjqd
穲	htnu
穳	hjlv
穴	nv
穵	nvz
究	nvx
穷	nvj
穸	nvd
穹	nvzs
空	nvi
穻	nvf
穼	nvm
穽	nvfn
穾	nvjy
穿	nvcj
窀	nvtl
突	nvyd
窂	nvki
窃	nvtd
窄	nvlk
窅	nvg
窆	nvjz
窇	nvse
窈	nvwj
窉	nvtv
窊	nvjn
窋	nvue
窌	nvcp
窍	nvis
窎	nvgt
窏	nvsf
窐	nvll
窑	nvlu
窑	nvke
窒	nvtl
窓	nvgu
窔	nvdx
窕	nvvv
窖	nvjo
窗	nvjd
窘	nveo
窙	nvyz
窚	nvjx
窛	nvfr
窜	nvoi
窝	nvov
窞	nvrg
窟	nvpe
窠	nvbm
窡	nvaa
窢	nvtx
窣	nvdx
窤	nvbu
窥	nvfw
窦	nvxy
窧	nvyx
窨	nvdb
窩	nvqo
窪	nvsl
窫	nvfy
窬	nvvn
窭	nvxr
窮	nvrs
窯	nvvh
窰	nvju
窱	nvtm
窲	nvxx
窳	nvjn
窴	nvxv
窵	nvgh
窶	nvor
窷	nvpp
窸	nvju
窹	nvko
窺	nvfw
窻	nvju
窼	nvsm
窽	nvtv
窾	nvlv
窿	nvpl
竀	nvtw
竁	nvjl
竂	nvym
竃	nvll
竄	nvgv
竅	nvga
竆	nvro
竇	nvlv
竈	nvlq
竉	nvde
竊	nvjg
立	diil
竌	dw
竍	dx
竎	dh
竏	djx
竐	dwa
竑	dxg
竒	doi
竓	djfl
竔	djh
竕	dvd
竖	nads
竗	dmj
竘	dso
站	dyoz
竚	dnt
竛	dvjd
竜	dbl
竝	dd
竞	dow
竟	dbw
章	dbx
竡	djb
竢	dgly
竣	dgva
竤	dnxg
童	dbl
竦	dtom
竧	dr
竨	dybx
竩	dnqf
竪	gad
竫	drei
竬	djog
竭	dbsl
竮	dpvh
端	dejn
竰	djbl
竱	dtbd
竲	dvqb
竳	dxtv
竴	dvud
竵	dtoy
競	doww
竷	dbxa
竸	dbww
竹	kiiz
竺	kfbz
竻	kj
竼	kwd
竽	kfby
竾	kc
竿	kfbg
笀	kdl
笁	ki
笂	kxd
笃	kst
笄	kth
笅	kxx
笆	kdl
笇	kdy
笈	kjzn
笉	ksv
笊	kj
笋	kej
笌	kcij
笍	knv
笎	kfw
笏	kss
笐	kdw
笑	kjy
笒	kvj
笓	ku
笔	kjfl
笕	knw
笖	kldv
笗	kadd
笘	kyo
笙	kjl
笚	kq
笛	kdbd
笜	kue
笝	kqa
笞	kgo
笟	kjjn
笠	kd
笡	kqf
笢	kptv
笣	kse
笤	kdo
笥	kjto
符	ktxd
笧	knnt
笨	kmt
笩	ktv
笪	kbt
笫	ksij
笫	kjsj
第	kzsj
笭	kvjd
笮	klk
笯	kra
笰	kzsn
笱	kso
笲	kgh
笳	kjo
笴	kto
笵	ksc
笶	kly
笷	kcjp
笸	kco
笹	khl
笺	kfx
笻	kip
笼	kxtd
笽	kq
笾	kjz
笿	kao
筀	kll
筁	ku
筂	ksc
筃	kqy
筄	kvwv
筅	kjlw
筆	kef
筇	kip
筈	kjxo
等	klxd
筊	kdvx
筋	kdj
筌	kve
筍	ksb
筎	kro
筏	ktx
筐	kce
筑	kiwd
筒	knto
筓	kff
答	kvto
筕	ksfi
策	ktnm
筗	ktoi
筘	kfo
筙	kem
筚	kux
筛	knti
筜	kwe
筝	krei
筞	knm
筟	kjz
筠	klsv
筡	kvtm
筢	kfdl
筣	khn
筤	kdek
筥	koo
筦	knfw
筧	kgw
筨	kvjo
筩	kdnf
筩	kddi
筪	kcq
筫	kgv
筬	kjjx
筭	keh
筮	kivv
筯	kqfj
筰	ktlk
筱	ktia
筲	kwd
筳	kjlz
筴	kyvv
筴	ktvv
筵	kjlz
筶	kjlo
筷	kyzv
筸	kbf
筹	kfxd
筺	kced
筻	ktbx
筼	kob
筽	koty
签	kvtw
筿	kam
简	knbj
箁	kdo
箂	kxvv
箂	ktvm
箃	kpa
箄	kgjx
箅	kqtn
箆	knvu
箇	kqxo
箈	ksgo
箉	kfoj
箊	kdhd
箋	kxx
箌	ktgn
箍	kfci
箎	kyw
箏	kjei
箐	kld
箑	ktel
箒	keni
箓	kes
箔	ksg
箕	khev
箖	kmm
算	kgh
箘	kqh
箙	kdpa
箚	kvtn
箛	kzjn
箜	knvi
箝	kfhf
箞	kvyc
箟	kbu
箠	kjxf
箠	kjtl
管	knpz
箢	kndc
箣	ktnn
箤	kdvx
箥	ksja
箦	klb
箧	kctv
箨	kfaf
箩	kqd
箪	kvbx
箫	kemn
箫	keii
箬	khxo
箭	kvdn
箮	kntt
箯	kttx
箰	ksbz
箱	kmg
箲	ksjw
箳	kpvh
箴	kjtx
箵	kmjg
箶	kxod
箷	kdhc
箸	kyb
箹	kwmd
箺	kevb
箻	ksef
箼	kptl
箽	kjtl
箾	kwdn
箿	kop
節	kegp
篁	kge
篂	kbjl
篃	kdjg
範	kcc
篅	kejn
篆	kljx
篇	kdph
篈	klld
築	kiwm
篊	kshv
篋	kctv
篌	ktzy
篍	khx
篎	kgmj
篏	khfv
篐	kmci
篑	kqb
篒	kvdk
篓	kxr
篔	kogv
篕	klgq
篖	kjeo
篗	ktia
篘	ksuj
篙	kdoo
篚	kcee
篛	kzsv
篜	kjxh
篝	kfnl
篞	ksbl
篟	ktld
篠	ktim
篡	kgyg
篢	kigv
篣	kdnh
篤	ksh
篥	kcm
篦	kjqu
篧	kpii
篨	kpvm
篩	kjpi
篪	kjjw
篫	kiwf
篬	kvdo
篭	kdbl
篮	knkq
篯	kvfx
篰	kdop
篱	kdxg
篲	kffe
篳	kbhf
篴	kxz
篵	ksvl
篶	ktlh
篷	kafz
篸	kggs
篹	kgyc
篺	kfgx
篻	kcfm
篼	kgcw
篽	kslp
篾	kqjx
篿	ktbd
簀	klgv
簁	ksll
簂	kqtx
簃	khdd
簄	kdpl
簅	kdjl
簆	knfa
簇	kdhy
簈	kpjf
簉	kjlz
簊	khel
簋	kekq
簌	ktov
簍	kotr
簎	kfhb
簏	kjzu
簐	kcrv
簑	kdok
簒	kgyg
簓	knls
簔	kdtk
簕	khpj
簖	kxlt
簗	ksdm
簘	kexn
簙	kxtd
簚	kqtx
簛	khet
簜	ksbs
簝	kyvm
簞	koox
簟	kcbx
簠	ktdq
簡	knb
簢	kndx
簣	kqgv
簤	kqgv
簥	kjyo
簦	kxtv
簧	khdv
簨	keev
簩	kxxj
簪	kcwb
簫	keik
簬	kolo
簭	kivo
簮	kfvb
簯	kmhv
簰	kkgx
簱	kdhv
簲	kdgx
簳	kxbf
簴	kywv
簵	kcao
簶	kjys
簷	krji
簸	khea
簹	kwnq
簺	knfl
簻	kqoz
簼	kffl
簽	kvtv
簾	kjvm
簿	kstd
籀	kfgq
籁	ktob
籂	kvdi
籃	kgkq
籄	kcqv
籅	kjkv
籆	khta
籇	kdox
籈	kcld
籉	klol
籊	kjji
籋	ktvx
籌	kljd
籍	kemb
籎	ktll
籏	kdhv
籐	kdvs
籑	kgyk
籒	kftq
籓	ksjq
籔	kota
籕	kmgq
籖	klnx
籖	klex
籗	kuti
籘	kdvm
籙	kves
籚	kyqq
籛	kvxx
籜	kfqy
籜	kfqx
籝	kdld
籞	kslm
籟	ktov
籠	kdde
籡	kfvv
籢	kvta
籣	kntm
籤	kvvx
籥	kvth
籦	kvjl
籧	kyxz
籨	kvtv
籩	kjgz
籪	kwwt
籫	kjlv
籬	kdxi
籭	ktnu
籮	kqwi
籯	kdld
籰	kgga
籱	kuti
籲	kvtv
米	xiim
籴	jnx
籵	xx
籶	xw
籷	xjt
籸	xzx
籹	xr
籺	xlz
类	xy
籼	xeux
籼	xeus
籽	xzuz
籾	xdd
籿	xxd
粀	xxn
粁	xjx
粂	rdx
粃	xu
粄	xjja
粅	xss
粆	xmj
粇	xdw
粈	xjxt
粉	xvdf
粊	ux
粋	xxx
粌	xzsi
粍	xjfl
粎	xpn
粏	xyd
粐	xdp
粑	xdl
粒	xdul
粓	xhf
粔	xg
粕	xgup
粖	xtm
粗	xqf
粘	xyo
粙	xd
粚	xlc
粛	exn
粜	uex
粝	xjth
粞	xc
粟	cxbs
粠	xhv
粡	xnto
粢	vrvx
粣	xnnt
粤	jqxs
粥	zsxs
粦	xdci
粧	xjl
粨	xjb
粩	xyt
粪	xhvf
粫	xjnn
粬	xu
粭	xvto
粮	xdek
粯	xgw
粰	xjz
粱	sdvx
粲	ydax
粳	xtbx
粴	xbl
粵	jnjs
粶	xes
粷	xsx
粸	xhev
粹	xdvx
粺	xgjx
粻	xk
粼	xdck
粽	xnfm
精	xldj
粿	xbm
糀	xhtt
糁	xgys
糂	xhel
糃	xbts
糃	xbjs
糄	xdph
糅	xdtm
糆	xjqf
糇	xtzy
糈	xjld
糉	xxua
糊	xxod
糋	xvdn
糌	xayb
糍	xvww
糎	xjbl
糏	xpwd
糐	xtdd
糑	xzsv
糒	xhji
糒	xhjf
糓	lnta
糔	xadq
糕	xveh
糖	xjeo
糗	xjgd
糘	xnx
糙	xjlz
糚	xhkl
糛	xwnl
糜	jmmx
糝	xggs
糞	xqhv
糟	xub
糠	xjes
糡	xdbw
糢	xhby
糣	xcwb
糤	xhda
糥	xjnn
糦	xloo
糧	xbtl
糨	xzsq
糩	xvtb
糪	podx
糫	xqtk
糬	xqyb
糭	xdxa
糮	xgkq
糯	xujn
糰	xqtd
糱	ujjx
糲	xjhg
糳	wtyx
糳	wtvx
糴	jnxi
糴	jdxi
糵	hjpx
糶	uexi
糷	xhnm
糸	wm
糹	wm
糺	wml
系	jwm
糼	wmj
糽	wmt
糾	wmli
糿	wmd
紀	wmzl
紁	wmad
紂	wmxd
紃	wmm
約	wmsd
紅	wmi
紆	wmf
紇	wmlz
紈	wmxd
紉	wmdd
紊	dxwm
紋	wmdx
紌	wmxd
納	wmnv
紎	wmyd
紏	wmdx
紐	wmjt
紑	wmjy
紒	wmvn
紓	wmdt
純	wmtl
紕	wmu
紖	wmzi
紗	wmmj
紘	wmxg
紙	wmcv
級	wmjn
紛	wmvd
紜	wmfg
紝	wmjl
紞	wmpl
紟	wmvj
素	lwms
紡	wmdh
索	xnwm
紣	wmxx
紤	wmjt
紥	flwm
紦	wmdl
紧	nawm
紨	wmtd
紩	wmkv
紪	wmlt
紫	ltwm
紬	wmd
紭	wmzg
紮	mlwm
累	qwm
細	wmq
紱	wmxd
紲	wmhl
紳	wmbi
紴	wmja
紵	wmnt
紶	wmlg
紷	wmvd
紸	wmde
紹	wmdo
紺	wmhf
紻	wmny
紼	wmzn
紽	wmnt
紾	wmvs
紿	wmgo
絀	wmue
絁	wmlc
終	wmad
絃	wmdw
組	wmqf
絅	wmno
絆	wmvx
絇	wmso
絈	wmg
絉	wmmd
絊	wmmt
絋	wmjg
経	wmal
絍	wmtl
絎	wmsi
絏	wmbx
結	wmlo
絑	wmkm
絒	wmyy
絓	wmll
絔	wmjb
絕	wmdl
絖	wmww
絗	wmqo
絘	wmvv
絙	wmtt
絚	wmtt
絛	tiam
絜	fdwm
絝	wmys
絞	wmdx
絟	wmve
絠	wmxd
絡	wmao
絢	wmsb
絣	wmvh
絤	wmc
絥	wmtd
給	wmvo
絧	wmno
絨	wmtx
絩	wmvv
絪	wmqy
絫	gggm
絬	wmjo
絭	vywm
絮	rowm
絯	wmdv
絰	wmtl
統	wmdw
絲	wmwm
絳	wmai
絴	wmvf
絵	wmvg
絶	wmrl
絷	fxdm
絸	wmgw
絹	wmod
絺	wmxi
絻	wmrw
絼	wmj
絽	wmoo
絾	wmjx
絿	wmxd
綀	wmtm
綁	wmfp
綂	wmdw
綃	wmwd
綄	wmnw
綅	wmea
綆	wmtx
綇	wmu
綈	wmvj
綉	wmhj
綊	wmtv
綋	wmng
綌	wmvo
綍	wmxz
綎	wmjz
綏	wmjr
綐	wmvw
綑	wmqm
綒	wmjz
經	wmti
綔	yfsm
綕	wmlu
綖	wmjz
綗	wmno
綘	wmaf
継	wmxl
続	wmlw
綛	wmdu
綜	wmnm
綝	wmmm
綞	wmjl
綞	wmjf
綟	wmdd
綠	wmls
綡	wmdm
綢	wmno
綣	wmvc
綤	dopm
綥	wmqn
綦	hevm
綧	wmdz
綨	wmhv
綩	wmnc
綪	wmld
綫	wmxx
綬	wmja
維	wmti
綮	dpam
綯	wmsu
綰	wmnz
綱	wmne
網	wmnl
綳	wmdd
綴	wmaa
綵	wmjm
綶	wmbm
綷	wmdx
綸	wmvh
綹	wmao
綺	wmyo
綻	wmnl
綼	wmgx
綽	wmyx
綾	wmla
綿	wmgi
緀	wmtr
緁	wmtl
緂	wmxx
緃	wmvl
緄	wmbu
緅	wmpa
緆	wmbs
緇	wmsq
緈	wmly
緈	wmlx
緉	wmtd
緊	gawm
緋	wmne
緋	wmee
緌	wmhr
緍	wmcb
緎	wmtx
総	wmvu
緐	lqsm
緑	wmes
緒	wmyb
緓	wmhy
緔	wmwo
緕	wmdh
緖	wmyb
緗	wmmg
緘	wmjx
緙	wmhp
線	wmgs
緛	wmjy
緜	gnim
緝	wmop
緞	wmja
緟	wmjl
締	wmdi
緡	wmpb
緢	wmhq
緣	wmlx
緤	wmhm
緥	wmtm
緦	wmqu
緧	wmvu
編	wmdh
緩	wmja
緪	wmyt
緫	wmsu
緬	wmjf
緭	wmqd
緮	wmla
緯	wmzi
緰	wmvn
緱	wmty
緲	wmgj
緳	jfdm
練	wmtm
緵	wmxa
緶	wmtx
緷	wmnc
緸	wmcl
緹	wmbl
緺	wmqo
緻	wmta
緼	wmbq
緽	wmyv
緾	wmjl
緿	wmgu
縀	wmpa
縁	wmex
縂	wmvu
縃	wmjd
縄	wmbl
縅	wmjx
縆	wmyt
縇	wmnt
縈	xxnm
縉	wmtb
縊	wmvq
縋	wmjz
縌	wmvz
縍	wmdh
縎	wmqd
縏	nswm
縐	wmsj
縑	wmvm
縒	wmvi
縓	wmjm
縔	wmam
縕	wmqq
縖	wmno
縗	wmdk
縘	wmjy
縙	wmhp
縚	wmjg
縛	wmtd
縜	wmov
縝	wmxv
縞	wmdo
縟	wmjd
縠	lnta
縡	wmnx
縢	dvym
縣	qemm
縤	wmlm
縥	wmeh
縦	wmsl
縧	wmtm
縨	wmbw
縩	wmxm
縪	wmbf
縫	wmaz
縬	wmjx
縭	wmdg
縮	wmnb
縯	wmnv
縰	wmsl
縱	wmsl
縲	wmqm
縳	wmtd
縴	wmdi
縵	wmba
縶	lyxm
縶	lvxm
縷	wmor
縸	wmhy
縹	wmcm
縺	wmcz
縻	jmmm
縼	wmdl
總	wmju
績	wmlv
縿	wmgs
繀	wmei
繁	lqsm
繂	wmdx
繃	wmed
繄	clym
繅	wmsm
繆	wmjs
繇	jlxm
繈	wmzq
繉	wmgv
繊	wmlx
繋	ccwm
繌	wmja
繍	wmen
繎	wmdh
繏	wmev
繐	wmtu
繑	wmjo
繒	wmvb
繓	wmba
織	wmdx
繕	wmvo
繖	wmha
繗	wmxi
繘	wmdo
繙	wmjq
繚	wmym
繛	lwmx
繜	wmvd
繝	wmnd
繞	wmlw
繟	wmox
繠	uuum
繡	wmek
繢	wmqv
繣	wmet
繤	hgym
繥	wmlo
繦	wmzq
繧	wmug
繨	wmlz
繩	wmq
繪	wmvb
繫	cuwm
繬	wmxo
繭	hmwq
繮	wmtt
繯	wmqk
繰	wmom
繱	wmhu
繲	wmri
繳	wmga
繴	podm
繵	wmdt
繶	wmdu
繷	wmuk
繸	wmvz
繹	wmqy
繹	wmqx
繺	wmrh
繻	wmun
繼	wmwl
繽	wmnv
繾	wmqz
繿	wmgq
纀	wmtv
纁	wmjh
纂	kgym
纃	wmdh
纄	wmhz
纅	wmwm
纆	wmql
纇	xwmv
纈	wmlv
纉	wmfv
纊	wmjv
纋	wmja
續	wmlv
纍	qqqm
纎	wmlx
纏	wmjl
纐	wmdv
纑	wmyq
纒	wmjl
纓	wmgr
纔	wmrd
纕	wmdk
纖	wmvx
纗	wmeo
纘	wmjv
纙	wmqi
纚	wmtu
纛	lqsm
纜	wmgw
纝	wmqm
纞	wmwu
纟	wii
纠	wli
纡	wf
红	wi
纣	wxd
纤	wjx
纥	wlz
约	wsd
级	wjzn
纨	wxd
纩	wjuk
纪	wzl
纫	wddr
纬	wfji
纭	wfg
纮	wxg
纯	wtul
纰	wu
纱	wmj
纲	wnx
纳	wnv
纴	wjl
纵	wvv
纶	wvt
纷	wvd
纸	wctv
纹	wdx
纺	wdh
纻	wnt
纼	wzsi
纽	wjxt
纾	wdt
线	wfx
绀	whf
绁	whl
绂	wxad
练	wtjv
组	wqf
绅	wbi
细	wqux
织	wov
终	wadd
绉	wre
绊	wvx
绋	wzsn
绌	wue
绍	wdo
绎	waf
经	wzi
绐	wgo
绑	wfp
绒	wtxx
结	wlo
绔	wyfs
绕	wxtw
绖	wtgl
绗	wsfi
绘	wvfg
给	wvto
绚	wsb
绛	waci
络	wao
绝	wrdl
绞	wdvx
统	wdgw
绠	wtbx
绡	wwd
绢	wod
绣	whzj
绤	wvvo
绥	wjr
绦	wam
继	wxl
绨	wvzj
绩	wlb
绪	wyb
绫	wlva
绬	whny
续	wxjy
绮	wyto
绯	wene
绰	wybx
绱	wwno
绲	wbu
绳	wobl
维	wti
绵	wgni
绶	wjna
绷	wddb
绸	wnlo
绹	wslu
绺	wayo
绻	wvyc
综	wnfm
绽	wntl
绾	wnpz
绿	wes
缀	waaa
缁	wsq
缂	whp
缃	wmg
缄	wjtx
缅	wjqf
缆	wnkw
缇	wbtl
缈	wgmj
缉	wop
缊	wbq
缋	wqb
缌	wqu
缍	wjxf
缎	wjia
缏	wttx
缐	wgs
缑	wtzy
缒	wjpz
缓	wjfa
缔	wdni
缕	wxr
编	wdph
缗	wptb
缘	wljx
缙	wtwb
缚	wtdd
缛	wjfd
缜	wxqv
缝	wafz
缞	wdok
缟	wdoo
缠	wjbl
缡	wdxg
缢	wvvq
缣	wvem
缤	wngv
缥	wcfm
缦	wbqa
缧	wqwm
缨	wbbr
缩	wntb
缪	wjjs
缫	wsbm
缬	wlob
缭	wyvm
缮	wvfo
缯	wvqb
缰	wtqt
缱	wqpz
缲	woom
缳	wqtk
缴	wgda
缵	wjlb
缶	lxu
缶	ke
缷	lxup
缸	lxui
缸	kei
缹	lxuh
缺	lxuv
缺	kezv
缻	lxud
缼	lxuv
缽	lxut
缾	lxuh
缿	lxuo
罀	lxuv
罁	lxue
罂	bblu
罃	xxnu
罄	ldju
罅	lxui
罅	keyi
罆	lxuv
罇	lxud
罈	lxux
罉	lxuf
罊	cuwu
罋	dwju
罌	gvgu
罍	qqqu
罎	lxug
罏	lxuq
罐	lxui
罐	kehi
网	nxx
罒	qii
罔	nvdl
罕	nvf
罖	qvd
罗	qd
罘	qjy
罙	nvm
罚	qin
罛	qjjn
罜	qde
罝	qqf
罞	qdtj
罟	qxo
罠	qptv
罡	qtl
罢	qlg
罣	qll
罤	qvzj
罥	qod
罦	qjz
罧	qmm
罨	qybl
罩	qybx
罪	qene
罫	qlly
罬	qaaa
罭	qtox
置	qxqe
罯	qdb
罰	qin
罱	qxny
罱	qxnx
署	qyb
罳	qqu
罴	qlgh
罵	qsh
罶	qgdq
罷	qgdt
罸	qixd
罹	qyti
罺	qsbm
罻	qpfd
罼	qbhf
罽	qjxn
罾	qvqb
罿	qdbl
羀	nxxq
羁	qhpt
羂	qwmd
羃	qhbi
羄	qwmx
羅	qwmi
羆	qgdh
羇	qhpo
羈	qhph
羉	qwmm
羊	vfby
羊	vfay
羋	yiyf
羌	vflq
羍	yvf
美	vey
羏	vfs
羐	yyln
羑	vern
羒	vfvd
羓	vfdl
羔	veh
羕	vedx
羖	vfwa
羗	vflg
羘	dvf
羙	vex
羚	vfvd
羛	vezn
羜	vfnt
羝	vfcd
羞	vfjt
羟	vfzi
羠	vftv
羡	vevv
羢	vftx
羣	ejof
群	ejof
羥	vfti
羦	vfnw
羧	vfga
羨	vesv
義	vejx
羪	vfdk
羫	vfni
羬	vfjx
羭	vfvn
羮	vehv
羯	vfbl
羰	vfex
羱	vfjm
羲	vejx
羲	vehx
羳	vfjq
羴	vfvf
羵	vfxv
羶	vfdt
羷	vfvv
羸	dlof
羸	dlod
羹	vehy
羺	vfun
羻	vfja
羼	pvff
羽	jjuy
羾	jji
羿	jjh
翀	jjoi
翁	vgjj
翂	jjvd
翃	xgjj
翄	jjxa
翅	xajj
翆	jjxx
翇	jjxd
翈	qjj
翉	mtjj
翊	djj
翋	jjd
翌	jjd
翍	jjja
翎	vjdj
翏	jjvs
翐	jjkv
翑	jjso
習	jjg
翓	lojj
翔	vfjj
翕	vtoj
翖	vtoj
翗	ddjj
翘	xtwj
翙	edjj
翚	jjnc
翛	tiaj
翜	jjtv
翝	nxgj
翞	jjdm
翟	jjti
翠	jjdx
翡	neej
翡	enej
翢	nljj
翣	jjdr
翤	onhj
翥	ybjj
翦	vdnj
翧	ntbj
翨	jjbl
翩	dpnj
翪	jjxa
翫	jjgw
翬	jjnc
翭	jjty
翮	tonj
翯	jjdo
翰	xbxj
翱	gyxj
翲	cfmj
翳	clyj
翴	jjcz
翵	jjgh
翶	gxxj
翷	xdcj
翸	xhgj
翹	lllj
翺	jgxj
翻	jxqj
翼	jjqv
翽	ljtj
翾	qtoj
翿	ljij
耀	wwji
老	ytcl
老	ytbl
耂	yii
考	ys
耄	ytjl
者	ybcz
耆	ytb
耇	yso
耈	ytso
耉	yjso
耊	ytgl
耋	yttl
而	jnn
耍	jnnr
耎	jnny
耏	jnns
耐	jnnd
耑	ejnn
耒	em
耓	emt
耔	emz
耕	emfn
耖	emmj
耗	emjl
耘	emfg
耙	emdl
耚	emja
耛	emgo
耜	empz
耝	emqf
耞	emjo
耟	emg
耠	emvo
耡	emqj
耢	emhj
耣	emvh
耤	emhb
耥	emwo
耦	embg
耧	emxr
耨	emjd
耩	emfl
耪	emdh
耫	emlv
耬	emor
耭	emwx
耮	emxj
耯	emha
耰	emja
耱	emjc
耲	emdk
耳	piie
耴	pl
耵	ptud
耶	ppuy
耷	yp
耸	vvp
耹	pvj
耺	pfg
耻	pluc
耼	pnf
耽	ppl
耾	pxg
耿	pxug
聀	px
聁	pvd
聂	paa
聃	pnl
聄	pvs
聅	ply
聆	pvjd
聇	ptl
聈	pwj
聉	pue
聊	pcjp
聋	xtdp
职	pov
聍	pntn
聎	pvwv
聏	pjnn
聐	plo
聑	pp
聒	pjxo
聓	iwdp
联	pvy
聕	pjlo
聖	poe
聗	pyvv
聗	ptvv
聘	pdts
聙	pld
聚	pax
聚	pajv
聛	pgjx
聜	pnvi
聝	ptox
聞	nnp
聟	lyop
聠	pvh
聡	pvgu
聢	pntl
聣	pgw
聤	pdot
聥	pjog
聦	pssu
聧	pxty
聨	pwwh
聩	pqb
聪	pvou
聫	pwwy
聬	pvgj
聭	pgwg
聮	pwwh
聯	pwwh
聰	pjqu
聱	lhap
聲	ldjp
聳	svvp
聴	pxqu
聵	pqgv
聶	ppp
職	pdbx
聸	prji
聹	pnut
聺	pnxm
聻	scjp
聼	jpxu
聽	pexu
聾	ddtp
聾	ddsp
聿	ef
肀	ei
肁	dpef
肂	tdef
肃	emn
肃	eiji
肄	tlyf
肅	eikk
肆	kef
肇	dpaf
肈	dpxf
肉	nvv
肊	dz
肋	djul
肌	dwuj
肍	dx
肎	nd
肏	jnnv
肐	dlz
肑	dsd
肒	dxd
肓	dldh
肔	dc
肕	ddd
肖	wdbx
肖	wdbs
肗	dr
肘	dxd
肙	od
肚	dlud
肛	diug
肜	ds
肝	dfug
肞	dad
肟	dfs
肠	dzs
股	dwa
肢	dxa
肣	dvj
肤	dfv
肥	ddl
肦	dvd
肧	djy
肨	df
肩	dpd
肪	ddh
肫	dtul
肬	dxld
肭	dnv
肮	ddw
肯	ldbk
肰	dyd
肱	dxg
育	dgd
肳	dss
肴	xxdy
肵	djjt
肶	du
肷	drv
肸	dvx
肹	dvts
肺	dtni
肻	ynd
肼	dfn
肽	dyd
肾	nad
肿	doiz
胀	dkuz
胁	djv
胂	dbi
胃	qdbw
胄	ddbz
胅	dkv
胆	dbt
胇	dzsn
胈	dxad
胉	dg
胊	dso
胋	dyo
背	ktd
胍	djjn
胎	dgo
胏	dsij
胏	djsj
胐	due
胑	dov
胒	dpt
胓	dtvi
胔	ltnv
胕	dtxd
胖	dvx
胗	dvs
胘	ddw
胙	dlk
胚	djyt
胛	dquj
胜	djls
胝	dctd
胞	dse
胟	dqs
胠	dlg
胡	xod
胢	dto
胣	dlc
胤	jwdl
胥	jldx
胦	dny
胧	dxtd
胨	dtm
胩	dly
胪	dyp
胫	dzi
胬	ranv
胭	dqy
胮	daci
胯	dyfs
胰	dtzv
胱	dww
胲	ddyv
胳	dao
胴	dnto
胵	dtgl
胶	ddvx
胷	sxud
胸	dsxu
胹	djnn
胺	dnr
胻	dsfi
胼	dvh
能	gdtt
胾	lnvx
胿	dll
脀	jxtd
脁	dvwv
脂	dtb
脃	drdl
脄	dxx
脅	jjjd
脆	drjc
脇	djjj
脈	djjk
脉	ddjx
脊	xvdj
脋	dddd
脌	dlci
脍	dvfg
脎	dxm
脏	djl
脐	ddxn
脑	ddxu
脒	dxum
脓	dpk
脔	dmnv
脕	drow
脖	dxnz
脗	dsso
脘	dnfw
脙	dxxd
脚	dlgp
脛	dtsi
脜	djg
脝	ddoj
脞	dvvl
脟	djxd
脠	djlz
脡	djlz
脢	dlqs
脣	jfkd
脤	djfk
脥	dyvv
脥	dtvv
脦	dtuv
脧	dgva
脨	dtom
脩	tiad
脪	dxxi
脫	dvow
脬	djz
脭	doe
脮	djr
脯	dtdd
脰	dtov
脱	dvow
脲	dps
脳	dwxu
脴	djyo
脵	doty
脶	donv
脷	dhn
脸	dvtw
脹	dk
脺	ddvx
脻	dtel
脼	dtnd
脽	dti
脾	dgjx
脿	dlk
腀	dvth
腁	djff
腂	dbm
腃	dvyc
腄	djxf
腄	djtl
腅	dxx
腆	duv
腇	dhr
腈	dld
腉	dgw
腊	dhb
腋	ddtn
腌	dybl
腍	dvju
腎	gad
腏	daaa
腐	jtxv
腑	djtd
腒	dpxo
腓	dene
腔	dnvi
腕	dndc
腖	dtbm
腗	ddtn
腘	dqed
腙	dnfm
腚	dntl
腛	dptl
腜	dhfm
腝	djny
腞	dljx
腟	dntl
腠	devy
腡	dqo
腢	dbng
腣	ddni
腤	ddb
腥	dbjl
腦	dsjx
腧	dvtn
腨	dejn
腩	dxny
腩	dxnx
腪	dnc
腫	djtl
腬	ddtm
腭	doos
腮	dqu
腯	djjg
腰	dcr
腱	defz
腲	dqtk
腳	dvvp
腴	dgv
腵	dpfa
腶	djia
腷	dtoq
腸	dbts
腸	dbjs
腹	dlba
腺	dgs
腻	dtfv
腼	djqf
腽	dbq
腾	dvyt
腿	dekz
膀	ddnh
膁	dvem
膂	dhld
膃	dqvq
膄	dgia
膅	djeo
膆	dlwm
膇	djpz
膈	dtoy
膉	dvvq
膊	dtdd
膋	xxnd
膌	dxvd
膍	djqu
膎	djwy
膏	dond
膐	dhlv
膑	dngv
膒	dcoo
膓	dlbs
膔	djzu
膕	dqtx
膖	dafz
膗	deti
膘	dcfm
膙	dzsq
膚	yqd
膛	dwnl
膜	dhby
膝	dmvs
膞	dtbd
膟	ddwx
膟	ddvx
膠	djjs
膡	dvyg
膢	dotr
膣	dnvl
膤	due
膥	tmjv
膦	dxdi
膧	ddbl
膨	dlos
膩	dtfv
膪	ddno
膫	dyvm
膬	djfl
膭	dqgv
膮	dllw
膯	dxtv
膰	djxq
膱	ddbx
膲	dtih
膳	dvfo
膴	dlhh
膵	dhdx
膶	dne
膷	dwjp
膸	dxiz
膹	dxhv
膺	jttd
膻	ddqt
膼	dqoz
膽	drji
膾	dvtb
膿	dujk
臀	phvd
臁	djvm
臂	podd
臃	ddwi
臅	dqsq
臆	ddbu
臇	dtim
臈	dhbl
臉	dvtv
臊	doom
臋	phvv
臌	dloa
臍	dddh
臎	djjx
臏	dntv
臐	djth
臑	dujn
臒	dhta
臓	dhjx
臔	dgav
臕	djzh
臖	jknd
臗	dnhd
臘	dsqv
臙	dhoh
臙	dhkh
臚	dyqq
臛	duti
臜	djlb
臝	dlom
臝	dlod
臞	dggi
臟	dhkx
臠	wmiv
臡	hofv
臢	djlv
臣	giic
臤	ga
臥	gv
臦	gg
臧	kgx
臨	gloo
臩	ggyn
自	jgbz
自	jgaz
臫	jgl
臬	jgm
臭	jgyd
臮	jgjv
臯	jgxx
臰	jgtt
臱	jgnh
臲	jgmc
至	tgl
致	tgla
臵	tglo
臶	tglz
臷	ltgx
臸	tgll
臹	tglx
臺	lonl
臻	tglh
臼	gjiu
臼	gii
臽	rg
臾	gvay
臿	jxg
舀	jgby
舁	gh
舂	evg
舃	gsh
舄	gsh
舅	gqj
舆	jkcv
與	jksv
興	jknv
舉	jksf
舊	htig
舋	jknf
舌	jxo
舍	vfo
舎	vlo
舏	jxoi
舐	jxov
舑	jxol
舒	vfot
舓	jxos
舔	jxod
舕	jxox
舖	vfod
舗	vlod
舘	vfoz
舙	jxoo
舚	jxoi
舛	dci
舜	jndi
舝	zisi
舞	lhdi
舟	nsaz
舠	nsd
舡	nsi
舢	nse
舣	nsdx
舤	nswd
舥	nsdl
舦	nsyd
舧	nsjd
舨	nsja
舩	nsvg
航	nsdw
舫	nsdh
般	nswa
舭	nsu
舮	nsdp
舯	nsoi
舰	nsnw
舱	nsvc
舲	nsvd
舳	nsd
舴	nslk
舵	nsnt
舶	nsg
舷	nsdw
舸	nsto
船	nswo
舺	nsq
舻	nsyp
舼	nshv
舽	nsai
舾	nsc
舿	nsys
艀	nsjz
艁	nsjo
艂	nsaf
艃	nsbl
艄	nswd
艅	nsvm
艆	nsdk
艇	nsjz
艈	nsdm
艉	nspl
艊	nsgi
艋	nszq
艌	nsvu
艍	nspo
艎	nsge
艏	nsvg
艐	nsxa
艑	nsdh
艒	nsng
艒	nsbg
艓	nshm
艔	nsja
艕	nsdh
艖	nsvi
艗	nsvq
艘	nsga
艙	nsvo
艚	nsub
艛	nsor
艜	nshi
艝	nsue
艞	nskv
艟	nsdl
艠	nsxv
艡	nswq
艢	nsxo
艣	nsyj
艤	nsvx
艥	nsox
艦	nsgq
艧	nsha
艨	nshx
艩	nsdh
艪	nsrb
艫	nsyq
艬	nsrd
艭	nsta
艮	ek
良	dek
艰	aek
艱	hofk
色	rdl
艳	frdl
艴	zsnl
艵	vhrl
艶	utol
艷	ffel
艸	ujui
艸	hii
艹	hii
艺	hzby
艻	hj
艼	ht
艽	hxbj
艾	hxba
艿	hzj
芀	hd
芁	hw
节	hpbj
芃	hwd
芄	hxd
芅	hv
芆	had
芇	hni
芈	yyf
芉	hf
芊	hjx
芋	hfby
芌	hfs
芍	hsd
芎	hzs
芏	hlbd
芐	htd
芑	hzl
芒	hdl
芓	hz
芔	uiui
芕	hd
芖	hy
芗	hwj
芘	hu
芙	hfv
芚	htul
芛	hej
芜	hfl
芝	hdz
芞	hkz
芟	hwa
芠	hdx
芡	hrv
芢	htf
芣	hjy
芤	hzl
芥	hvn
芦	hdp
芧	hdt
芨	hjzn
芩	hvj
芪	hctv
芫	hfw
芬	hvd
芭	hdlb
芮	hnvr
芯	hubx
芰	hxa
花	htt
芲	hvt
芳	hdh
芴	hss
芵	hzv
芶	hsg
芷	hlbz
芸	hfg
芹	hjjt
芺	hjy
芻	sujj
芼	hjfl
芽	hcij
芾	htni
芿	htzj
苀	hdw
苁	hvv
苂	hx
苃	hxa
苄	hdy
苅	hxn
苆	htd
苇	hfji
苈	hjj
苉	hcw
苊	hjc
苋	hnw
苌	hk
苍	hvc
苎	hnt
苏	hjv
苐	hzsj
苑	hdc
苒	hnl
苓	hvjd
苔	hgo
苕	hdo
苖	hd
苗	hqbm
苘	hno
苙	hd
苚	hnf
苚	hdi
苛	hto
苜	hgbm
苝	hkt
苞	hse
苟	hso
苠	hptv
苡	hldv
苢	hpz
苣	hgbj
苤	hjyt
若	hxor
苦	hxok
苧	hnt
苨	hpt
苩	hg
苪	htnv
苫	hyo
苬	hqv
苭	hwj
苮	hte
苯	hmt
苰	hzsg
英	hny
苲	hlk
苳	hadd
苴	hqf
苵	hkv
苶	hvm
苷	hhf
苸	hjvi
苹	htvi
苺	hqs
苻	htxd
苼	hjl
苽	hjjn
苾	huj
苿	hfm
茀	hzsn
茁	hue
茂	hjxm
范	hsc
茄	hjo
茅	hdtj
茆	hcjp
茇	hxad
茈	hlt
茉	htm
茊	hg
茋	hctd
茌	htl
茍	hso
茎	hzi
茏	hxtd
茐	hssd
茑	hgt
茒	hdp
茓	hnv
茔	hnl
茕	hnzx
茖	hao
茗	hdo
茘	hddd
茙	htxx
茚	hep
茚	hctp
茛	hek
茜	hcbq
茝	hg
茞	hg
茟	hef
茠	htm
茡	hnz
茢	htdn
茣	hoty
茤	hdd
茥	hll
茦	htnm
茧	hqbj
茨	hvrv
茩	hjjo
茪	hww
茫	hsdl
茬	hxil
茭	hdvx
茮	hlm
茯	htyd
茰	hbx
茱	hkm
茲	hww
茳	hsi
茴	hqo
茵	hqy
茶	hvm
茷	htx
茸	hpbr
茹	hro
茺	hdgw
茻	ujui
茼	hnto
茽	htoi
茾	hth
茿	hiwd
荀	hsb
荁	htbt
荂	hyfs
荃	hveq
荃	hvec
荄	hdyv
荅	hvto
荆	hthn
荇	hsfi
荈	hdci
草	hbxc
荊	hthn
荋	hjnn
荌	hnr
荍	hlia
荎	htgl
荏	htjl
荐	hxiz
荑	htzv
荒	hdlm
荓	hvh
荔	hjjj
荕	hdj
荖	hyt
荗	hjdx
荘	hkl
荙	hyz
荚	htvv
荛	hxtw
荜	hux
荝	hbn
荞	hjyn
荟	hvfg
荠	hdxn
荡	hszs
荢	hnf
荣	hnmr
荤	hnc
荥	hns
荦	hnki
荧	hnxy
荨	hexd
荩	hpnd
荪	hzm
荫	hpd
荬	hjdy
荭	hwi
荮	hwxd
药	hwsd
荰	hml
荱	hpjl
荲	hbl
荳	htov
荴	hffv
荵	hddu
荶	hovj
荷	htto
荸	hxnz
荹	hy
荺	hlsv
荻	hxjx
荼	hvtm
荽	hjr
荾	hgva
荿	hjjx
莀	hjfk
莁	hivv
莂	hojn
莃	hxxi
莄	htbx
莅	htd
莆	htdd
莇	hqfj
莈	hswa
莉	hhn
莊	hkl
莋	htlk
莌	hvow
莍	hxxd
莎	hsmj
莏	hfmj
莐	hspl
莑	haf
莒	hoo
莓	hlqs
莔	hqvn
莕	hmo
莖	htsi
莗	hc
莘	hdx
莙	hejo
莚	hjlz
莛	hjlz
莜	htia
莝	hvvl
莞	hnfw
莟	hvjo
莠	hhzj
莡	hol
莢	hyvv
莢	htvv
莣	hdlu
莤	hu
莥	hxjt
莦	hwd
莧	hgw
莨	hdek
莩	hjz
莪	hjfx
莫	hby
莬	hrow
莭	hegp
莮	hqj
莯	hsm
莰	hlrv
莱	htx
莲	hczl
莳	hbxd
莴	honv
莵	hjod
莶	hvtw
获	hxjd
莸	hxjd
莹	hned
莺	hngt
莻	hzjt
莼	hwtl
莽	hydh
莾	hyxh
莿	htnn
菀	hndc
菁	hld
菂	hgsd
菃	hsg
菄	htbm
菅	hnpz
菆	hpa
菇	hrxo
菈	hfd
菉	hes
菊	hsx
菋	hofm
菌	hqhj
菍	hvju
菎	hbu
菏	hsto
菐	wtvv
菑	hsq
菒	hbm
菓	hbm
菔	hdpa
菕	hvth
菖	hbb
菗	hfd
菘	hmvg
菙	hjxf
菙	hjtl
菚	hxx
菛	hn
菜	hjm
菝	hfxd
菞	hhsj
菟	hrod
菠	hsja
菡	hjxu
菢	hfse
菣	hga
菤	hvyc
菥	hmjt
菦	hjjz
菧	hjcd
菨	hdr
菩	hdo
菪	hnc
菫	htol
菬	hsdo
菭	hsgo
菮	hjev
華	hthf
菰	hzjn
菱	hlva
菲	hene
菳	hv
菴	hybl
菵	hnvl
菶	hevf
菷	heni
菸	hdhd
菹	hsqf
菺	hdpd
菻	hmm
菼	hxx
菽	hlma
菾	htyd
菿	htgn
萀	hyw
萁	hhev
萂	hho
萃	hdvx
萄	hslu
萅	htub
萆	hgjx
萇	hk
萈	hgwd
萉	hddl
萊	hxvv
萊	htvm
萋	hter
萌	hbd
萍	hsti
萎	hhr
萏	hrg
萐	htel
萑	hti
萒	hdvw
萓	hnqf
萔	hfdo
萕	hdxh
萖	hgw
萗	hnfm
萘	hyfm
萙	hmpl
萚	hfaf
萛	hgh
萜	hnio
萝	hqd
萞	hnvu
萟	hhxd
萠	hdd
萡	hsg
萢	hsse
萣	hntl
萤	hnq
营	hnoo
萦	hnwm
萧	hemn
萧	heii
萨	hpdj
萩	hhx
萪	hhdx
萫	hhb
萬	hbng
萭	hjog
萮	hvtn
萯	hrgv
萰	htqm
萱	hntt
萲	hjfa
萳	hxny
萳	hxnx
萴	hgvn
萵	hqo
萶	hevb
萷	hwdn
萸	hgv
萹	hdph
萺	hnfg
萺	hbg
萻	hdb
萼	hoos
落	hsao
萾	hzjq
萿	hsjo
葀	hfjo
葁	hver
葂	hroj
葃	hblk
葄	hdlk
葅	hvvf
葆	htom
葇	hdtm
葈	hgom
葉	hhlm
葊	hvth
葋	hdso
葌	hrrr
葍	htoq
葎	hsef
葏	hsef
葐	hvdq
葑	hlld
葒	hwmi
葓	hshv
葔	htzy
葕	hssi
葖	hnvd
著	hyb
葘	htsq
葙	hmg
葚	hhel
葛	hbsl
葜	hfdy
葝	htsj
葞	hzsp
葟	hge
葠	htea
葡	hstd
葢	hydq
董	hjtl
葤	hwmd
葥	hvdn
葦	hzii
葧	hxnj
葨	hqtk
葩	hgdl
葪	hrn
葫	hxod
葬	htdh
葭	hpfa
葮	hjia
葯	hwmd
葰	htga
葱	hssu
葲	hgs
葳	hjtx
葴	hjtx
葵	hxty
葶	hdot
葷	hnc
葸	hqu
葹	hdhc
葺	hop
葻	hwjq
葼	hxua
葽	hcr
葾	hdcu
葿	hdjg
蒀	hbq
蒁	hmdz
蒂	hdni
蒃	hljx
蒄	hnfd
蒅	hsxm
蒆	hiwr
蒇	hjbx
蒈	hug
蒉	hqb
蒊	httt
蒋	hkdd
蒌	hxr
蒍	hdjh
蒎	hsjk
蒏	hnu
蒐	hgwg
蒑	hjja
蒒	hjpi
蒓	hwml
蒔	hbld
蒕	hqvq
蒖	hxqv
蒗	hsdk
蒘	hrof
蒙	hnfx
蒚	htoy
蒛	hlxv
蒜	hfmm
蒝	hjgm
蒞	hstd
蒟	hdso
蒠	hjgu
蒡	hdnh
蒢	hpvm
蒣	hsvm
蒤	hsvm
蒥	hgdq
蒦	htia
蒧	hjyx
蒨	htld
蒩	hhqf
蒪	htdd
蒫	hvfi
蒬	hnrd
蒭	hsuj
蒮	hpii
蒯	hddn
蒰	hnsa
蒱	hftd
蒲	hstd
蒳	hwmv
蒴	hvud
蒵	hjwy
蒶	hwmd
蒷	hogv
蒸	hjxh
蒹	hvem
蒺	hjly
蒻	hzsv
蒼	hvdo
蒽	hqyu
蒾	hxz
蒿	hdoo
蓀	hzjm
蓁	hevh
蓂	hnbv
蓃	hgia
蓄	hdwq
蓅	hsdm
蓆	hjhi
蓇	hqd
蓈	hdep
蓉	hnvo
蓊	hvgj
蓋	hlgq
蓌	hvva
蓍	hytb
蓎	hjeo
蓏	hjjn
蓐	hjfd
蓑	hdok
蓒	hcf
蓓	htdo
蓔	hveh
蓕	hmll
蓖	hjqu
蓗	hsll
蓘	hdvk
蓙	hjvl
蓚	htis
蓛	htna
蓜	huzl
蓝	hnkq
蓞	hjg
蓟	hrtn
蓠	hdxg
蓡	hsea
蓢	hded
蓣	hdtb
蓤	hvla
蓥	hnvy
蓦	hbyt
蓧	htim
蓨	htid
蓩	hdtj
蓪	hdnz
蓪	hddz
蓫	hxz
蓬	hafz
蓭	hjyl
蓮	hcz
蓯	hsvl
蓰	hsll
蓱	hsvh
蓲	hcoo
蓳	hhol
蓴	htbd
蓵	hftl
蓶	hoti
蓷	hfti
蓸	hub
蓹	hslp
蓺	hlvd
蓻	hlyd
蓻	hlvd
蓼	hjjs
蓽	hbhf
蓾	hyqd
蓿	hntb
蔀	hdop
蔁	hdbx
蔂	hqwm
蔃	hzsq
蔄	hno
蔅	hnr
蔆	hsla
蔇	hegw
蔈	hcfm
蔉	hdvk
蔊	hxbf
蔋	hsla
蔌	htov
蔍	hjzu
蔎	hiwa
蔏	hdno
蔐	hdno
蔑	hqjx
蔒	hejh
蔓	hbqa
蔔	hstq
蔕	hhwi
蔕	hhni
蔖	hyqf
蔗	hjhh
蔘	hggs
蔙	hdhl
蔚	hpfd
蔛	hrdx
蔜	hlha
蔝	hgx
蔞	hotr
蔟	hdhy
蔠	hwmd
蔡	hxfm
蔢	hsjr
蔣	hkdd
蔤	hnue
蔥	hjqu
蔦	hgh
蔧	hffe
蔨	hqvc
蔩	hntv
蔪	hcjt
蔫	htlh
蔬	hjlm
蔭	hpvg
蔮	hqtx
蔯	hptm
蔰	hdpl
蔱	hxma
蔲	hnfa
蔳	hsld
蔴	hjmm
蔵	hjgx
蔶	hlgv
蔷	hxvo
蔸	hgcw
蔸	hcgw
蔹	hvta
蔺	hnti
蔻	hnfa
蔼	hibl
蔽	hvna
蔾	hhsm
蔿	hjjh
蕀	htnm
蕁	heid
蕂	hdvj
蕃	hjxq
蕄	hnu
蕅	hsbg
蕆	hjgx
蕇	hoox
蕈	hcbx
蕉	htih
蕊	huuu
蕋	hlll
蕌	hbbb
蕍	hsvn
蕎	hjyo
蕏	hxjb
蕐	htvf
蕑	hnd
蕒	hqgv
蕓	hufg
蕔	hlya
蕔	hlva
蕕	hxju
蕖	hsgm
蕗	holo
蕘	hllw
蕙	htbu
蕚	hoos
蕛	hhvj
蕜	hneu
蕜	henu
蕝	hwml
蕞	hbpa
蕟	hxza
蕠	hrom
蕡	hxhv
蕢	hqgv
蕣	hjni
蕤	hxjl
蕥	hcii
蕦	hsjv
蕧	hsla
蕨	hjvv
蕩	hsbs
蕪	hlhh
蕫	hdbl
蕬	hwmm
蕭	heik
蕮	hgsh
蕯	hpal
蕰	hsbq
蕱	hhwd
蕲	hvbt
蕳	hnb
蕴	hwbq
蕵	hdvk
蕶	huvd
蕷	hdtv
蕸	hpfz
蕹	hdwi
蕺	hopx
蕻	hkhv
蕼	hkef
蕽	hujk
蕾	huq
蕿	hxja
薀	hsqq
薁	hjny
薂	hgda
薃	hsdo
薄	hstd
薅	hrjd
薆	hjna
薇	hsea
薈	hvtb
薉	hljx
薊	hrhn
薋	hvrv
薌	hwjp
薍	hjdl
薎	hqnx
薏	hdbu
薐	hhla
薑	htqt
薒	hydx
薓	hsea
薔	hxvo
薕	hjvm
薖	hqoz
薗	hqlk
薘	hlvz
薙	hlyi
薚	htds
薛	hjpx
薜	hpox
薝	hrji
薞	htdk
薟	hvtv
薠	hxjv
薡	hgkk
薢	hrdi
薣	hloa
薤	htdt
薥	hqsq
薦	hjzh
薧	hdot
薨	hqnt
薩	hpdl
薪	hdmt
薫	hjth
薬	hvgm
薬	hgxm
薭	hhgx
薮	hxra
薯	hqyb
薰	hjth
薱	hwtd
薲	hntv
薳	hloz
薴	hnut
薵	hljd
薶	hjbl
薷	hujn
薸	hscm
薹	hlol
薺	hddh
薻	hssm
薼	hjzl
薽	hcld
薾	htvx
薿	htll
藀	hxxx
藁	hdom
藂	hpax
藃	hdov
藄	hhem
藅	hqin
藆	hnff
藇	hjkv
藈	hgxy
藉	hemb
藊	hhdh
藋	hjji
藌	hnuq
藍	hgkq
藎	helq
藎	heiq
藏	hkgx
藐	hjgw
藑	hrna
藒	hhbl
藓	hrtf
藔	hnym
藕	hemg
藖	hgav
藗	htoz
藘	hyqu
藙	hdxa
藚	hlqv
藛	hngh
藜	hhss
藝	hlvg
藞	hccc
藟	hqqq
藠	hggg
藡	hdnz
藢	hsea
藣	hqgt
藤	hdvs
藥	hwgm
藥	hgwm
藦	hjmf
藧	hwma
藨	hjzh
藩	hsjq
藪	hota
藫	hscx
藬	hpqv
藭	hnvs
藮	hmth
藯	hpfu
藰	hgdn
藱	hjgg
藲	hmco
藳	hdoh
藴	hwmq
藵	htok
藶	hjhl
藷	hiyb
藸	hxyb
藹	hibl
藺	hnti
藻	hsom
藼	hnlu
藽	hdmw
藾	htov
藿	huti
蘀	hfqy
蘀	hfqx
蘁	heoo
蘂	huum
蘃	hllm
蘄	hoot
蘅	hsri
蘆	hyqq
蘇	hrhh
蘈	hhwv
蘉	hqna
蘊	hwmq
蘋	hyjv
蘌	hslm
蘍	hjtj
蘎	hudl
蘏	htfv
蘐	hija
蘑	hjmc
蘒	hhrl
蘓	hhrh
蘔	hthv
蘕	hwmz
蘖	hjpm
蘗	hpom
蘘	hdok
蘙	hclj
蘚	hrhf
蘛	hhed
蘜	hhpx
蘝	hvtv
蘞	hvta
蘟	hpju
蘠	hkxo
蘡	hgvr
蘢	hdde
蘣	hhde
蘤	hgjh
蘥	hvth
蘦	huoo
蘧	hyxz
蘨	hjlm
蘩	hlqm
蘪	hjzx
蘫	hsgq
蘬	hjpi
蘭	hntm
蘮	hqjn
蘯	hsbq
蘰	hwma
蘱	hxyv
蘲	hqql
蘳	hhdl
蘴	hffv
蘵	hpdx
蘶	hhrg
蘷	hjba
蘸	huth
蘹	hydk
蘺	hdxi
蘻	hcum
蘼	hjme
蘽	hqqm
蘾	hldk
蘿	hqwi
虀	hddt
虁	hvja
虂	huoo
虃	hsvx
虄	hqal
虅	hdvh
虆	hqqm
虇	hzsi
虈	hooo
虈	hjgo
虉	htoh
虊	hwmm
虊	hiwm
虋	hjkd
虌	hvnq
虍	yiih
虎	yw
虏	yjcl
虐	yct
虑	yu
虒	jjyw
虓	xyw
虔	ydx
處	yaw
虖	yjvi
虗	yg
虘	yqf
虙	yuj
虚	ywt
虛	ywt
虜	yqj
虝	ywss
虞	yoty
號	otsw
虠	dvxw
虡	ywtv
虢	jxdw
虣	flvw
虤	ywyw
虥	ywxx
虦	xxyw
虧	ytis
虨	ymms
虩	wbmw
虪	ywth
虫	qiic
虬	ql
虭	qd
虮	qw
虯	qli
虰	qt
虱	zjq
虲	qy
虳	qsd
虴	qjt
虵	qc
虶	qf
虷	qf
虸	qz
虹	qiuh
虺	twq
虻	qdl
虼	qlz
虽	oqbs
虾	qtd
虿	thq
蚀	rlq
蚁	qdxy
蚂	qst
蚃	wjq
蚄	qdh
蚅	qjc
蚆	qdl
蚇	qpn
蚈	qth
蚉	dxq
蚊	qdxw
蚋	qnv
蚌	qfub
蚍	qu
蚎	qb
蚏	qd
蚐	qsv
蚑	qxa
蚒	qnd
蚓	qzsi
蚔	qctv
蚕	tyq
蚖	qfw
蚗	qzv
蚘	qxld
蚙	qvj
蚚	qjjt
蚛	qoi
蚜	qcij
蚝	qjfl
蚞	qm
蚟	qe
蚠	vdq
蚡	qvd
蚢	qdw
蚣	qvg
蚤	adq
蚥	qvx
蚦	qnf
蚧	qvnz
蚨	qfv
蚩	ulq
蚩	uitq
蚪	qddx
蚫	qse
蚬	qnw
蚭	qpt
蚮	qtv
蚯	qguq
蚯	qguc
蚰	qduy
蚱	qlk
蚲	qtvi
蚳	qctd
蚴	qwj
蚵	qto
蚶	qhf
蚷	qg
蚸	qjjd
蚹	qtxd
蚺	qnl
蚻	mlq
蚼	qso
蚽	qjyt
蚾	qja
蚿	qdw
蛀	qde
蛁	qdo
蛂	qxad
蛃	qtnv
蛄	qxo
蛅	qyo
蛆	qqf
蛇	qnt
蛈	qkv
蛉	qvjd
蛊	qqbg
蛋	jlq
蛌	qjjn
蛍	wnq
蛎	qjth
蛏	qal
蛐	quuq
蛐	quuc
蛑	qgki
蛒	qao
蛓	lqx
蛔	qqo
蛕	qxd
蛖	qxld
蛗	jpzq
蛘	qvf
蛙	qllw
蛚	qtdn
蛛	qkm
蛜	qtej
蛝	qek
蛞	qjxo
蛟	qdvx
蛠	qjjj
蛡	qjj
蛢	qvh
蛣	qlo
蛤	qvto
蛥	qdd
蛦	qtzv
蛧	qnxx
蛨	qjb
蛩	iwdq
蛪	fdq
蛫	qrjc
蛬	hvq
蛭	qtgl
蛮	dmq
蛯	qyt
蛰	fxdq
蛱	qtvv
蛲	qxtw
蛳	qnti
蛴	qdxn
蛵	qtsi
蛶	qjxd
蛷	qxxd
蛸	qwd
蛹	qdnf
蛹	qddi
蛺	qyvv
蛺	qtvv
蛻	qvow
蛼	qc
蛽	qgv
蛾	qjfx
蛿	qvjo
蜀	qsq
蜁	qljl
蜂	qaf
蜃	jfkq
蜄	qjfk
蜅	qtdd
蜆	qgw
蜇	fjjq
蜈	qoty
蜉	qjz
蜊	qhn
蜋	qdek
蜌	qul
蜍	qvtm
蜎	qod
蜏	qhzj
蜐	qlgj
蜑	jlzq
蜒	qjlz
蜓	qjlz
蜔	qsq
蜕	qvow
蜖	qqnf
蜗	qonv
蜘	qlyo
蜙	qmvg
蜚	neeq
蜚	eneq
蜛	qpxo
蜜	nujq
蜝	hevq
蜞	qhev
蜟	qdgd
蜠	qqh
蜡	qhb
蜢	qzq
蜣	qvfl
蜤	mjjq
蜥	qmjt
蜦	qvth
蜧	qdpd
蜨	qtel
蜩	qnlo
蜪	qslu
蜫	qbu
蜬	qjxu
蜭	qrg
蜮	qtox
蜯	qevf
蜰	ddlq
蜱	qgjx
蜲	qhr
蜳	qdoz
蜴	qbss
蜵	qktk
蜶	qdvx
蜷	qvyc
蜸	gaq
蜹	qhnv
蜺	qgw
蜻	qldc
蜼	qti
蜽	qtnd
蜾	qbm
蜿	qndc
蝀	qtbm
蝁	txtq
蝂	qkja
蝃	qaaa
蝄	qnvl
蝅	tytq
蝆	qyif
蝇	qobl
蝈	qqed
蝉	qvbx
蝊	qntl
蝋	qwwf
蝌	qhdx
蝍	qegp
蝎	qbsl
蝏	qdot
蝐	qbg
蝑	qjld
蝒	qjqf
蝓	qvtn
蝔	qug
蝕	vdeq
蝖	qntt
蝗	qge
蝘	qcbr
蝙	qdph
蝚	qdtm
蝛	qjtx
蝜	qrgv
蝝	qljx
蝞	qdjg
蝟	qqd
蝠	qtoq
蝡	qjny
蝢	qjgv
蝣	qdhz
蝤	qvu
蝥	dtjq
蝦	qpfa
蝧	qhny
蝨	zxqq
蝩	qjtl
蝪	qbts
蝪	qbjs
蝫	qyb
蝬	qxua
蝭	qbtl
蝮	qlba
蝯	qjfa
蝰	qyll
蝱	dlqq
蝲	qton
蝳	qlqs
蝴	qxod
蝵	hxq
蝶	qhlm
蝷	qjvj
蝸	qqo
蝹	qbq
蝺	qjog
蝻	qxny
蝻	qxnx
蝼	qxr
蝽	qevb
蝾	qhnm
蝿	qbbl
螀	kdxq
螁	qekz
螂	qdep
螃	qdnh
螄	qjpi
螅	qjgu
螆	qvww
螇	qjwy
螈	qjgm
螉	qvgj
螊	qvem
螋	qgia
螌	nswq
融	tonq
螎	qtoy
螏	qjly
螐	qjzh
螑	qjgd
螒	xbxq
螓	qevh
螔	qjjw
螕	qjqu
螖	qqd
螗	qjeo
螘	qetv
螙	mqq
螚	gdtq
螛	qnfo
螜	lntq
螝	qgwg
螞	qsh
螟	qnbv
螠	qvvq
螡	dxqq
螢	xxnq
螣	dvyq
螤	dxqv
螥	qvdo
螦	qlwm
螧	qytb
螨	qhtv
螩	qtim
螪	qdno
螫	lmaq
螬	qub
螭	qdxg
螮	qhwi
螮	qhni
螯	lhaq
螰	qjzu
螱	pfmq
螲	qnvl
螳	qwnl
螴	ptbq
螵	qcfm
螶	gqq
螷	jgjq
螸	vvoq
螹	qcjt
螺	qqwm
螻	qotr
螼	qhol
螽	addq
螾	qntv
螿	kdxq
蟀	qdwx
蟀	qdvx
蟁	ptvq
蟂	qgm
蟃	qbqa
蟄	lyxq
蟄	lvxq
蟅	qjhh
蟆	qhby
蟇	hbyq
蟈	qqtx
蟉	qjjs
蟊	dtjq
蟋	qjxu
蟌	qjqu
蟍	qhnm
蟎	qhnd
蟏	qhen
蟏	qhei
蟐	qwni
蟑	qdbx
蟒	qhyh
蟓	qrox
蟓	qrbx
蟔	qqh
蟕	qltr
蟖	qhet
蟗	toiq
蟘	qtvv
蟙	qdbx
蟚	lovq
蟛	qlos
蟜	qjyo
蟝	qsgm
蟞	vnmq
蟟	qyvm
蟠	qjxq
蟡	qjjh
蟢	qloo
蟣	qwwx
蟤	qeev
蟥	qhdv
蟦	qxhv
蟧	qxxj
蟨	jvuq
蟩	qjvv
蟪	qtbu
蟫	qcbx
蟬	qoox
蟭	qtih
蟮	qvfo
蟯	qllw
蟰	qeik
蟱	qlhh
蟲	qqq
蟳	qeid
蟴	hevq
蟵	qjtd
蟶	qpoe
蟷	qwnq
蟸	xqq
蟹	rdkq
蟺	qdqt
蟻	qvex
蟼	hsoq
蟽	qlvz
蟾	qrji
蟿	cuwq
蠀	qvrv
蠁	wjdq
蠂	qhhm
蠃	dloq
蠃	dlod
蠄	qvdg
蠅	qq
蠆	hbnq
蠇	qhbg
蠈	gvtq
蠉	qqtk
蠊	qjvm
蠋	qqsq
蠌	qqly
蠌	qqlx
蠍	qbsv
蠎	qhyh
蠏	qrdi
蠐	qddh
蠑	qxxm
蠒	tvnq
蠓	qhnx
蠔	qdox
蠕	qujn
蠖	qhta
蠗	qjji
蠘	qltx
蠙	qntv
蠚	hxoq
蠛	qhqx
蠜	mxxq
蠝	qqqq
蠞	kegq
蠟	qsqv
蠠	jqnq
蠡	ljxq
蠢	evbq
蠣	qjhg
蠤	vuqq
蠥	ujjq
蠦	qyqq
蠧	lncq
蠨	qhek
蠩	qiyb
蠪	ddtq
蠪	ddsq
蠫	jnqq
蠬	qdde
蠭	afzq
蠮	qclj
蠯	jgjq
蠰	qdok
蠱	qqqq
蠲	vvqq
蠳	qgvr
蠴	qhqb
蠵	qeto
蠶	cwcq
蠷	qggi
蠸	qhoi
蠹	toiq
蠺	tytq
蠻	wmiq
蠼	qgga
蠽	mjiq
蠾	qpsq
蠿	jwwq
蠿	ewwq
血	jqbx
血	jqbs
血	jqas
衁	dljq
衂	jqdd
衃	jqjy
衄	jqjt
衅	jqvx
衆	jqx
衆	jqtv
衆	jqjv
衇	jqjk
衈	jqp
衉	jqao
衊	jqhx
衋	efjq
行	sfi
衍	ssfi
衎	sffi
衏	sfwi
衐	sgfi
衑	svji
衒	sdwi
術	smdi
衔	svfi
衕	snti
衖	shvi
街	slli
衘	slxi
衘	slti
衙	swoi
衚	sxoi
衛	szii
衜	svji
衝	sjti
衞	szii
衟	ssji
衠	sxqi
衡	sryi
衢	sggi
衣	dkby
衤	jk
补	jky
衦	jkf
衧	jkf
表	lkbb
衩	jkad
衪	jkc
衫	jks
衬	jkxd
衭	jkfv
衮	dvgk
衯	jkvd
衰	dotk
衱	jkjn
衲	jknv
衳	jkvg
衴	jkpl
衵	jkb
衶	jkoi
衷	doik
衸	jkvn
衹	jkcv
衺	dcik
衻	jknf
衼	jkxa
衽	jkjl
衾	vjdk
衿	jkvj
袀	jksv
袁	lok
袂	jkzv
袃	tddk
袄	jkjy
袅	gdk
袆	jkfi
袇	jknd
袈	jodk
袉	jknt
袊	jkvd
袋	tvdk
袌	dsek
袍	jkse
袎	jkwj
袏	jkxi
袐	jkuj
袑	jkdo
袒	jkbt
袓	jkqf
袔	jkto
袕	jknv
袖	jkdx
袖	jkds
袗	jkvs
袘	jklc
袙	jkg
袚	jkxd
袛	jkcd
袜	jktm
袝	jktd
袞	dvok
袟	jkkv
袠	dkvk
袡	jknl
袢	jkvx
袣	jkhl
袤	ddtk
袥	jkc
袦	jkue
袧	jkso
袨	jkdw
袩	jkyo
袪	jklg
被	jkja
袬	dgok
袭	xtdk
袮	jklm
袯	jkyd
袰	qsdk
袱	jktd
袲	dddk
袳	jkdd
袴	jkys
袵	jktl
袶	jkai
袷	jkvo
袸	jkxz
袹	jkjb
袺	jklo
袻	jkjn
袼	jkao
袽	jkro
袾	jkkm
袿	jkll
裀	jkqy
裁	ldkx
裂	tdnk
裃	jkld
裄	jksi
装	kldk
裆	jkwe
裇	jkjq
裈	jknc
裉	jkek
裊	gdk
裋	jktv
裌	jktv
裍	jkqm
裎	jkoe
裏	dblk
裐	jkod
裑	jkr
裒	dgk
裓	jktx
裔	dkno
裕	jkvo
裖	jkjk
裗	jkdm
裘	xxdk
裙	jkeo
裚	fjjk
裛	dodk
補	jktd
裝	kldk
裞	jkvw
裟	smjk
裠	ejok
裡	jkbl
裢	jkcz
裣	jkvw
裤	jkjc
裥	jknb
裦	dedk
裧	jkxx
裨	jkgx
裩	jkbu
裪	jksu
裫	jkkk
裬	jkla
裭	jkyw
裮	jkbb
裯	jkno
裰	jkaa
裱	jklk
裲	jktd
裳	wnok
裴	neek
裴	enek
裵	dnek
裵	denk
裶	jkne
裶	jkee
裷	jkvc
裸	jkbm
裹	dbmk
裺	jkyl
裻	lmak
裼	jkbs
製	knik
裾	jkpo
裿	jkyo
褀	jkhv
褁	bmk
褂	jkly
褃	jkld
褄	jktr
褅	jkdi
褆	jkbl
複	jkla
褈	jkjl
褉	jkfy
褊	jkdh
褋	jkhm
褌	jknc
褍	jken
褎	dehk
褏	dedk
褐	jkbl
褑	jkja
褒	dtok
褓	jktm
褔	jktq
褕	jkvn
褖	jklx
褗	jkcr
褘	jkzi
褙	jkkd
褚	jkyb
褛	jkxr
褜	dsek
褝	jkwx
褞	jkbq
褟	jkbj
褠	jkfl
褡	jkho
褢	dgwk
褣	jkno
褤	jklk
褥	jkjd
褦	jkgt
褧	pxdk
褨	jkvi
褩	nswk
褪	jkez
褫	jkjw
褬	jkam
褭	dshk
褮	xxnk
褯	jkji
褰	nfnk
褱	dqsk
褲	jkjc
褳	jkcz
褴	jknq
褵	jkdg
褶	jkjg
褷	jksl
褸	jkor
褹	jkld
褺	lyxk
褺	lvxk
褻	dlvk
褼	jkce
褽	pfmk
褾	jkcm
褿	jkub
襀	jklv
襁	jkzq
襂	jkgs
襃	deok
襄	dook
襅	jkbf
襆	jkwv
襇	jknb
襈	jkev
襉	jknd
襊	jkba
襋	jktm
襌	jkox
襍	jktm
襎	jkjq
襏	jkxa
襐	jkrx
襑	jked
襒	jkva
襓	jklw
襔	jkhd
襕	jknm
襖	jkjy
襗	jkqy
襗	jkqx
襘	jkvb
襙	jkom
襚	jkvz
襛	jkuk
襜	jkri
襝	jkvv
襞	podk
襟	jkmm
襠	jkwq
襡	jkqq
襢	jkdt
襣	jkjn
襤	jkgq
襥	jktv
襦	jkun
襧	jktx
襨	jkwd
襩	jklv
襪	jkhx
襫	jktv
襬	jkqt
襭	jklv
襮	jkbs
襯	jkdw
襰	jktv
襱	jkde
襲	ddtk
襲	ddsk
襳	jkvx
襴	jknm
襵	jkpp
襶	jklx
襷	jkjf
襸	jkjv
襹	jktu
襺	jkhq
襻	jkmf
襼	jkhg
襽	jkhm
襾	tnu
西	ciix
覀	cii
要	crby
覂	cjdz
覃	cbx
覄	ctyd
覅	crss
覆	csla
覇	chpd
覈	cgda
覉	chpo
覊	chph
見	gw
覌	agw
覍	mgw
覎	gwz
規	fvgw
覐	gwxx
覑	kgw
覒	jflw
覓	jgw
覔	jygw
覕	ujgw
視	jygw
覗	jtow
覘	yogw
覙	rmgw
覚	wngw
覛	jjkw
覜	vwvw
覝	fxgw
覞	gwgw
覟	lugw
覠	ejow
覡	ivvw
覢	xxgw
覣	hrgw
覤	ywgw
覥	uvgw
覦	vtdw
覧	gkgw
覨	oofw
覩	ybgw
親	dmgw
覫	dndw
覬	etow
覭	nbdw
覮	xxnw
覯	fntw
覰	yqfw
覱	ccjw
覲	holw
観	lxiw
覴	xtow
覵	ndgw
覶	jdnw
覷	ywtw
覸	nbgw
覹	gwsa
覺	jkxw
覻	ytow
覼	tvnw
覽	gkqw
覾	njxw
覿	lqgw
觀	hoow
见	nwbj
见	nwaj
观	anw
觃	nwz
规	fvnw
觅	jnw
视	jynw
觇	yonw
览	nknw
觉	wnnw
觊	ezlw
觋	ivvw
觌	xjdw
觍	uvnw
觎	vtdw
觏	fntw
觐	holw
觑	ywtw
角	riij
觓	rli
觔	rj
觕	jfr
觖	rzv
觗	rctv
觘	rmj
觙	rjzn
觚	rjjn
觛	rbt
觜	ltr
觝	rctd
觞	rlzs
觟	rll
觠	vyr
觡	rao
觢	fdr
解	rdki
觤	rrjc
觥	rww
触	rq
觧	rvf
觨	ris
觩	rxxd
觪	rdx
觫	rtom
觬	rgw
觭	ryto
觮	res
觯	rvbx
觰	ryb
觱	jtor
觲	rvei
觳	lnta
觴	rlbs
觵	rhdv
觶	roox
觷	jkxr
觸	rqsq
觹	rtim
觺	tlyr
觻	rwgm
觼	rrna
觽	retm
觾	rhoh
觾	rhkh
觿	reto
言	iiiy
訁	iii
訂	iit
訃	iiy
訄	xi
訅	iix
訆	iili
訇	si
計	iix
訉	iiwd
訊	iizx
訋	iisd
訌	iii
訍	iiad
討	iixd
訏	iif
訐	iif
訑	iic
訒	iidd
訓	iim
訔	ei
訕	iie
訖	iilz
託	iijt
記	iizl
訙	iixd
訚	ni
訛	iitt
訜	iivd
訝	iicj
訞	iijy
訟	iivg
訠	iizi
訡	iivj
訢	iijt
訣	iizv
訤	iixx
訥	iinv
訦	iipl
訧	iixd
訨	iil
訩	iixu
訪	iidh
訫	iiu
訬	iimj
設	iiwa
訮	iith
訯	iijn
訰	iitl
許	iilx
訲	iioi
訳	iipn
訴	iijd
訵	iiq
訶	iito
訷	iibi
訸	iih
訹	iimd
診	iivs
註	iide
証	iitl
訽	iiso
訾	lti
訿	iilt
詀	iiyo
詁	iixo
詂	iitd
詃	iidw
詄	iikv
詅	iivd
詆	iicd
詇	iiny
詈	qibl
詉	iira
詊	iivx
詋	iiow
詌	iihf
詍	iihl
詎	iig
詏	iiwj
詐	iilk
詑	iint
詒	iigo
詓	iilg
詔	iido
評	iiti
詖	iija
詗	iino
詘	iiue
詙	iixd
詚	iibt
詛	iiqf
詜	iiua
詝	iint
詞	iijo
詟	xtdi
詠	iidx
詡	iijj
詢	iisb
詣	iitb
詤	iivm
詥	iivo
試	iitv
詧	xi
詨	iidx
詩	iild
詪	iiek
詫	iint
詬	iijo
詭	iirc
詮	iive
詯	iijg
詰	iilo
話	iijo
該	iidv
詳	iivf
詴	iixd
詵	iijw
詶	iiyy
詷	iino
詸	iix
詹	rjvi
詺	iido
詻	iiao
詼	iixx
詽	iiff
詾	iisu
詿	iill
誀	iip
誁	iivh
誂	iivv
誃	iidd
誄	iiem
誅	iikm
誆	iice
誇	iiys
誈	iitl
誉	wvi
誊	vyi
誋	iizu
誌	iilu
認	iidu
誎	iitm
誏	iidk
誐	iijx
誑	iixe
誒	iigy
誓	fjji
誔	iijz
誕	iijz
誖	iixz
誗	iihn
誘	iihj
誙	iiti
誚	iiwd
誛	iiea
誜	iiga
誝	iivo
語	iiwo
誟	iiyz
誠	iijx
誡	iitx
誢	iigw
誣	iiiv
誤	iioy
誥	iijo
誦	iidf
誧	iitd
誨	iils
誩	iii
說	iivw
誫	iijk
説	iivw
読	iilw
誮	iiht
誯	iibb
誰	iiti
誱	iitl
課	iibm
誳	iipe
誴	iinm
誵	iixd
誶	iidx
誷	iinl
誸	iizw
誹	iine
誹	iiee
誺	iixv
誺	iitm
誻	iisb
誼	iinf
誽	iigw
誾	nni
調	iino
諀	iigx
諁	iiaa
諂	iirg
諃	iimm
諄	iidz
諅	hevi
諆	iihv
談	iixx
諈	iijl
諈	iijf
諉	iihr
諊	iisx
請	iild
諌	iitm
諍	iiri
諎	iihb
諏	iipa
諐	tomi
諑	iixd
諒	iidm
諓	iixx
諔	iila
諕	iiyw
論	iivh
諗	iivu
諘	iilk
諙	iicb
諚	iinl
諛	iigv
諜	iihm
諝	iijd
諞	iidh
諟	iibl
諠	iint
諡	iivq
諢	iinc
諣	iiqo
諤	iios
諥	iijl
諦	iidi
諧	iiug
諨	iitq
諩	iivt
諪	iidt
諫	iitm
諬	hxli
諭	iivn
諮	iivo
諯	iien
諰	iiqu
諱	iizi
諲	iicl
諳	iidb
諴	iijx
諵	iixy
諵	iixx
諶	iihl
諷	iiwq
諸	iiyb
諹	iibs
諺	iids
諻	iige
諼	iija
諽	iihp
諾	iiho
諿	iiop
謀	iihm
謁	iibl
謂	iiqd
謃	iibl
謄	dvyi
謅	iisj
謆	iidj
謇	nfni
謈	bhvi
謉	iigg
謊	iihm
謋	iidm
謌	iito
謍	xxni
謎	iixz
謏	iiga
謐	iiuq
謑	iijy
謒	iivo
謓	iixv
謔	iiyt
謕	iijw
謖	iiqa
謗	iidh
謘	iipx
謙	iivm
謚	iivq
講	iifl
謜	iijm
謝	iird
謞	iido
謟	iijg
謠	iidu
謡	iiju
謢	iita
謣	iius
謤	iicm
謥	iiju
謦	ldji
謧	iidg
謨	iihy
謩	hbyi
謪	iido
謫	iido
謬	iijs
謭	iivd
謮	iilv
謯	iiyf
謰	iicz
謱	iior
謲	iigs
謳	iico
謴	iiqv
謵	iijg
謶	iijh
謷	lhai
謸	iila
謹	iihl
謺	lyxi
謺	lvxi
謻	iihd
謼	iiyi
謽	zsoi
謾	iiba
謿	iixd
譀	iija
譁	iihf
譂	iiox
譃	iiyt
譄	iivb
譅	iidl
譆	iilo
譇	iiyb
譈	iida
證	iixv
譊	iilw
譋	iind
譌	iijh
譍	jtti
譎	iido
譏	iiwx
譐	iivd
譑	iijo
譒	iijq
譓	iitu
譔	iiev
譕	iilh
譖	iicb
譗	iiko
識	iidx
譙	iith
譚	iicx
譛	iifb
譜	iivb
譝	iiq
譞	iiqk
譟	iiom
譠	iidt
譡	iiwq
譢	iivz
譣	iivv
譤	iiga
譥	gdhi
警	hsoi
譧	iijm
譨	iiuk
譩	iidu
譪	iihl
譫	iiri
譬	podi
譭	iiga
譮	iivb
譯	iiqy
譯	iiqx
議	iivx
譱	vfii
譲	iidk
譳	iiun
譴	iiqz
譵	iiwd
譶	iii
護	iiha
譸	iild
譹	iidx
譺	iitl
譻	gvgi
譼	gkqi
譽	jksi
譾	iivj
譿	iifu
讀	iilv
讁	iidz
讂	iira
讃	iifv
讄	iiqq
讅	iinq
讆	szii
讇	iing
讈	iijl
讉	iiqz
變	wmia
讋	ddti
讋	ddsi
讌	iihh
讍	iieo
讎	tiii
讏	szii
讐	titi
讑	iivh
讒	iird
讓	iidk
讔	iipu
讕	iinm
讖	iivx
讗	iieo
讘	iipp
讙	iihi
讚	iijv
讛	iihg
讜	iiwh
讝	iioa
讞	iiyd
讟	iili
讠	iii
计	ix
订	itud
讣	iy
认	iv
讥	iwud
讦	if
讧	ii
讨	ixdt
让	il
讪	ie
讫	ilz
讬	ijt
训	im
议	idx
讯	izx
记	izl
讱	idd
讲	ifn
讳	ifji
讴	icx
讵	ig
讶	icij
讷	inv
许	ilx
讹	itt
论	ivt
讻	ixu
讼	ivg
讽	iwx
设	iwa
访	idh
诀	izv
证	itl
诂	ixo
诃	ito
评	itvi
诅	iqf
识	iov
诇	ino
诈	ilk
诉	ijjd
诊	ivs
诋	ictd
诌	ire
词	ijto
诎	iue
诏	ido
诐	ija
译	iaf
诒	igo
诓	ice
诔	iem
试	itiv
诖	ill
诗	ilxd
诘	ilo
诙	ixxh
诚	ijjx
诛	ikm
诜	ijlw
话	ijxo
诞	ijlz
诟	ijjo
诠	ive
诡	irjc
询	isb
诣	itb
诤	irei
该	idyv
详	ivf
诧	injt
诨	inc
诩	ijj
诪	ifxd
诫	ithx
诬	iivv
语	iwo
诮	iwd
误	ioty
诰	ijlo
诱	ihzj
诲	ilqs
诳	ixje
说	ivow
诵	idnf
诵	iddi
诶	igly
请	ild
诸	iyb
诹	ipa
诺	ihxo
读	ixjy
诼	ixd
诽	iene
课	ibm
诿	ihr
谀	igv
谁	iti
谂	ivju
调	inlo
谄	irg
谅	idom
谆	idoz
谇	idvx
谈	ixxt
谉	inbi
谊	inqf
谋	ihfm
谌	ihel
谍	ihlm
谎	ihdm
谏	itqm
谐	iug
谑	iyct
谒	ibsl
谓	iqd
谔	ioos
谕	ivtn
谖	ijfa
谗	irod
谘	ivro
谙	idb
谚	idjs
谛	idni
谜	ixz
谝	idph
谞	ijld
谟	ihby
谠	iwnw
谡	iqva
谢	irxd
谣	ijlu
谤	idnh
谥	ivvq
谦	ivem
谧	iujq
谨	ihol
谩	ibqa
谪	idno
谫	ivdd
谬	ijjs
谭	icbx
谮	icwb
谯	itih
谰	intm
谱	ivwb
谲	idto
谳	ixnd
谴	iqpz
谵	irji
谶	ivvx
谷	vvo
谸	jxvo
谹	vvog
谺	vvoj
谻	vvof
谼	vvov
谽	vvoo
谾	vvoi
谿	jwyo
豀	vvoy
豁	nfoo
豂	vvos
豃	vvoa
豄	vvov
豅	vvoe
豆	tov
豇	tovi
豈	etov
豉	tova
豊	utov
豋	xtov
豌	tovc
豍	tovx
豎	gatv
豏	tovm
豐	ffev
豑	utoj
豒	ffej
豓	ffeq
豔	ffeq
豕	xii
豖	xd
豗	twx
豘	xtul
豙	dx
豚	dxut
豛	xwa
豜	xth
豝	xdl
豞	xso
豟	xdpz
豠	xqf
象	rox
象	rbx
豢	vyx
豣	xff
豤	xek
豥	xdyv
豦	yx
豧	xtdd
豨	xxxi
豩	xx
豪	donx
豫	dtrx
豬	xyb
豭	xpfa
豮	xxhb
豯	xjwy
豰	lnfa
豱	xbq
豲	xjgm
豳	xxe
豴	xdno
豵	xsvl
豶	xxhv
豷	xlnv
豸	jii
豹	jsd
豺	jxj
豻	jf
豼	ju
豽	jnv
豾	jjyt
豿	jso
貀	jue
貁	jnv
貂	jdo
貃	jg
貄	jef
貅	jtm
貆	jtbt
貇	jek
貈	jns
貉	jao
貊	jjb
貋	jbf
貌	jgwm
貍	jbl
貎	jgw
貏	jgjx
貐	jvtn
貑	jpfa
貒	jejn
貓	jhq
貔	jjqu
貕	jjwy
貖	jvvq
貗	jotr
貘	jhby
貙	jcoo
貚	joox
貛	jhoi
貜	jgga
貝	gv
貞	ygv
貟	ggv
負	rgv
財	gvxj
貢	igv
貣	vgv
貤	gvc
貥	gvdw
貦	gvfw
貧	vdgv
貨	ttgv
販	gvja
貪	vjgv
貫	qxgv
責	lgv
貭	jjxv
貮	fgvv
貯	gvnt
貰	hlgv
貱	gvja
貲	ltgv
貳	tfgv
貴	qgv
貵	gygv
貶	gvjz
買	qgv
貸	tvgv
貹	gvjl
貺	gvow
費	zsnv
貼	gvyo
貽	gvgo
貾	gvcd
貿	gdgv
賀	jogv
賁	xhgv
賂	gvao
賃	tjlv
賄	gvxd
賅	gvdv
賆	gvvh
資	vrvv
賈	cgv
賉	gvjq
賊	gvtx
賋	gvdx
賌	dyvv
賍	gvjl
賎	gvex
賏	gvgv
賐	gvga
賑	gvjk
賒	gvvm
賓	ntjv
賓	ntiv
賔	ndjv
賕	gvxd
賖	gvvm
賗	gvoi
賘	gvjd
賙	gvno
賚	txvv
賚	tvvv
賛	fvfv
賜	gvbs
賝	gvnm
賞	wnov
賟	gvuv
賠	gvdo
賡	jevv
賢	gagv
賣	lqgv
賤	gvxx
賥	gvdx
賦	gvfv
賧	gvxx
賨	nfmv
賩	gvnm
質	jjtv
賫	xvvv
賬	gvk
賭	gvyb
賮	elhv
賮	eitv
賯	gvsz
賰	gveb
賱	gvnc
賲	tomv
賳	gvlx
賴	tomv
賵	gvng
賵	gvbg
賶	gvvo
賷	xoov
賸	dvyv
賹	gvvq
賺	gvvm
賻	gvtd
購	gvfl
賽	nfnv
賾	glgv
賿	gvjs
贀	clyv
贁	gvga
贂	gvgs
贃	gvou
贄	lyxv
贄	lvxv
贅	lhav
贆	gvyd
贇	dxfv
贈	gvvb
贉	gvcx
贊	jlwv
贋	jttv
贌	gvwv
贍	gvri
贎	gvhg
贏	dlov
贏	dlod
贐	gveq
贑	dbxv
贒	goiv
贓	gvkx
贔	gvgv
贕	cypv
贖	gvlv
贗	jtgv
贘	gvwv
贙	ywyv
贚	gvde
贛	dbxv
贜	gvhx
贝	biib
贞	ybbz
负	rb
贠	gb
贡	ibbg
财	bxj
责	lbbz
贤	nab
败	ba
账	bk
货	ttb
质	jjxb
贩	bjja
贪	vjb
贫	vdb
贬	bjdz
购	bsg
贮	bnt
贯	qxb
贰	tfbv
贱	bfx
贲	xhb
贳	hlb
贴	byo
贵	qbbg
贶	bow
贷	tvb
贸	gdb
费	zsnb
贺	job
贻	bgo
贼	btxx
贽	fxdb
贾	cb
贿	bxdh
赀	ltb
赁	tjlb
赂	bao
赃	bjlz
资	vrvb
赅	bdyv
赆	bpnd
赇	bxxd
赈	bjfk
赉	txb
赊	bvfm
赋	bflv
赌	bybd
赍	xvvb
赎	bxjy
赏	wnob
赐	bbss
赑	bbb
赒	bnlo
赓	jevb
赔	bdop
赕	bxx
赖	tomb
赗	bnfg
赗	bbg
赘	lhab
赙	btdd
赚	bvem
赛	nfnb
赜	glb
赝	jttb
赞	jlwb
赟	dxfb
赠	bvqb
赡	brji
赢	dlod
赢	dlob
赣	dbxb
赤	lmbc
赥	lmrv
赦	lmas
赧	lmpa
赨	lmq
赩	lmrl
赪	lmyb
赫	lmlm
赬	lmyv
赭	lmyb
赮	lmpa
赯	lmjo
走	llbz
赱	lvz
赲	llj
赳	llli
赴	llyf
赵	llx
赶	llf
起	llzl
赸	lle
赹	llsv
赺	llvj
赻	llmj
赼	llrv
赽	llzv
赾	lljt
赿	llcv
趀	llsj
趁	llvs
趂	llrm
趃	llkv
趄	llqf
超	lldo
趆	llcd
趇	lld
趈	llyo
趉	llue
越	llcx
趋	llre
趌	lllo
趍	lldd
趎	llkm
趏	lljo
趐	lljj
趑	llvv
趒	llvv
趓	llwm
趔	lltn
趕	llbf
趖	llvl
趗	llol
趘	llpl
趙	llwd
趚	lltm
趛	llv
趜	llsx
趝	llvu
趞	llhb
趟	llwo
趠	llyx
趡	llti
趢	lles
趣	llpa
趤	llnc
趥	llvu
趦	llvo
趧	llbl
趨	llsj
趩	llqv
趪	llhv
趫	lljo
趬	lllw
趭	llth
趮	llom
趯	llji
趰	lltx
趱	lljb
趲	lljv
足	olbz
趴	olv
趵	olsd
趶	olf
趷	ollz
趸	thol
趹	olzv
趺	olfv
趻	olvj
趼	olth
趽	oldh
趾	oll
趿	oljn
跀	old
跁	oldl
跂	olxa
跃	oljy
跄	olvc
跅	oljd
跆	olgo
跇	olhl
跈	olvs
跉	olvd
跊	olfm
跋	olxd
跌	olkv
跍	olxo
跎	olnt
跏	oljo
跐	ollt
跑	olse
跒	olto
跓	olde
跔	olso
跕	olyo
跖	olc
跗	oltd
跘	olvx
跙	olqf
跚	olnt
跛	olja
跜	olpt
距	olgj
跞	olcm
跟	olek
跠	oltv
跡	oldm
跢	oldd
跣	oljw
跤	oldx
跥	olzm
跦	olkm
跧	olve
跨	olys
跩	olbx
跪	olrc
跫	iwdl
跬	olll
跭	olai
跮	oltl
路	olao
跰	olvh
跱	olld
跲	olvo
跳	olvv
跴	olc
践	olfx
跶	olyz
跷	olxw
跸	olux
跹	oljz
跺	olwm
跻	oldn
跼	olpo
跽	olzu
跾	tial
跿	olll
踀	olol
踁	olti
踂	olpl
踃	olwd
踄	oly
踅	fjjl
踆	olga
踇	olls
踈	oltm
踉	oldk
踊	oldf
踋	ollp
踌	olfd
踍	olyz
踎	oljo
踏	olsb
踐	olxx
踑	olhv
踒	olhr
踓	olti
踔	olyx
踕	oltl
踖	olhb
踗	olvu
踘	olsx
踙	olpa
踚	olvh
踛	olll
踜	olla
踝	olbm
踞	olpo
踟	ollo
踠	olnc
踡	olvc
踢	olbs
踣	oldo
踤	oldx
踥	oldr
踦	olyo
踧	olla
踨	olvl
踩	oljm
踪	olnm
踫	olvt
踬	oljb
踭	olri
踮	oljo
踯	olvp
踰	olvn
踱	olja
踲	oljg
踳	oleb
踴	oldj
踵	oljl
踶	olbl
踷	olyb
踸	olhl
踹	olen
踺	olez
踻	olqo
踼	olbs
踽	oljg
踾	oltq
踿	olhx
蹀	olhm
蹁	oldh
蹂	oldm
蹃	olho
蹄	oldi
蹅	olmt
蹆	olez
蹇	nfnl
蹈	oljg
蹉	olvi
蹊	oljy
蹋	olbj
蹌	olvo
蹍	olpk
蹎	olxv
蹏	oljw
蹐	olxd
蹑	olpa
蹒	olhv
蹓	olgq
蹔	ccjl
蹕	olbf
蹖	oleg
蹗	olju
蹘	oljs
蹙	jlml
蹚	olwl
蹛	olhi
蹜	olnb
蹝	olsl
蹞	oltv
蹟	ollv
蹠	oljh
蹡	olkd
蹢	oldo
蹣	olhd
蹤	olsl
蹥	olcz
蹦	oled
蹧	olub
蹨	oldh
蹩	vnml
蹪	olqv
蹫	oldo
蹬	olxv
蹭	olvb
蹮	olce
蹯	oljq
蹰	oljd
蹱	oldl
蹲	olvd
蹳	olxa
蹴	oldd
蹵	doml
蹶	oljv
蹷	jvul
蹸	olxi
蹹	olvj
蹺	ollw
蹻	oljo
蹼	olwv
蹽	olym
蹾	olda
蹿	olni
躀	olqv
躁	olom
躂	ollz
躃	olpx
躄	podl
躅	olqq
躆	olyx
躇	olhb
躈	olga
躉	hbnl
躊	olld
躋	oldh
躌	olli
躍	olji
躎	oltx
躏	olhi
躐	olsv
躑	olvp
躒	olwm
躓	oljv
躔	oljl
躕	oljd
躖	olwt
躖	olwi
躗	szil
躘	olde
躙	olni
躚	olcz
躛	szil
躜	oljb
躝	olnm
躞	olxa
躟	oldk
躠	hjpl
躡	olpp
躢	olnj
躣	olgi
躤	olhb
躥	olnv
躦	oljv
躧	oltu
躨	olva
躩	olga
躪	olhi
身	riis
躬	rzs
躭	rpl
躮	rvd
躯	rcxq
躯	rcxc
躰	rmt
躱	rzjm
躲	rwm
躳	roo
躴	rdek
躵	rddu
躶	rbm
躷	rhr
躸	ryto
躹	rsx
躺	rwno
躻	rnvi
躼	rk
躽	rcbr
躾	rvey
躿	rjes
軀	rcoo
軁	rotr
軂	rxxj
軃	roox
軄	rdbx
軅	rjti
軆	rutv
軇	rljd
軈	rjtu
軉	rnev
車	cii
軋	ccl
軌	ccx
軍	nc
軎	cobw
軏	cctw
軐	cczx
軑	ccy
軒	ccf
軓	ccwd
軔	ccdd
軕	cce
軖	cce
軗	ccwa
軘	cctl
軙	ccya
軚	ccyd
軛	ccjc
軜	ccnv
軝	cccv
軞	ccjl
軟	ccrv
軠	ccjl
軡	ccvj
転	ccfg
軣	cx
軤	ccji
軥	ccso
軦	ccow
軧	cccd
軨	ccvd
軩	ccgo
軪	ccwj
軫	ccvs
軬	gyc
軭	ccce
軮	ccny
軯	ccti
軰	ktc
軱	ccjn
軲	ccxo
軳	ccse
軴	ccde
軵	cctd
軶	ccdz
軷	ccxd
軸	ccd
軹	ccov
軺	ccdo
軻	ccto
軼	cckv
軽	ccal
軾	cctv
軿	ccvh
輀	ccjn
輁	cchv
輂	hvc
較	ccdx
輄	ccww
輅	ccao
輆	ccdv
輇	ccve
輈	ccns
載	lcx
輊	cctl
輋	eyc
輌	ccte
輍	ccvo
輎	ccwd
輏	ccu
輐	ccnw
輑	cceo
輒	ccpl
輓	ccrw
輔	cctd
輕	ccti
輖	ccno
輗	ccgw
輘	ccla
輙	ccpa
輚	ccxx
輛	cctd
輜	ccsq
輝	wwnc
輞	ccnl
輟	ccaa
輠	ccbm
輡	ccrg
輢	ccyo
輣	ccdd
輤	ccld
輥	ccbu
輦	fvfc
輧	ccjf
輨	ccnz
輩	neec
輩	enec
輪	ccvh
輫	ccne
輫	ccee
輬	ccdm
輭	ccjy
輮	ccdm
輯	ccop
輰	ccbs
輱	ccjx
輲	ccen
輳	ccey
輴	ccjg
輵	ccbl
輶	ccvu
輷	ccsi
輸	ccvn
輹	ccla
輺	cctq
輺	ccsq
輻	cctq
輼	ccbq
輽	ccgq
輾	ccpk
輿	jkcv
轀	ccqq
轁	ccjg
轂	lnta
轃	cceh
轄	ccno
轅	cclk
轆	ccju
轇	ccjs
轈	ccsm
轉	cctd
轊	ccfe
轋	cccz
轌	ccue
轍	ccda
轎	ccjo
轏	ccpz
轐	ccwv
轑	ccym
轒	ccxv
轓	ccjq
轔	ccxi
轕	cchl
轖	ccxo
轗	ccju
轘	ccqk
轙	ccvx
轚	cuwc
轛	ccwd
轜	ccun
轝	jksc
轞	ccgq
轟	ccc
轠	ccqq
轡	wmco
轢	ccwm
轣	ccjl
轤	ccyq
轥	cchi
车	ciic
轧	cluz
轨	cxug
轩	cfux
轩	cfus
轪	cy
轫	cdd
转	cfsd
轭	cjc
轮	cvt
软	crvr
轰	caa
轱	cxo
轲	cto
轳	cyp
轴	cduz
轵	cov
轶	ckv
轷	cjvi
轸	cvs
轹	ccm
轺	cdo
轻	czi
轼	ctiv
载	lcxz
轾	ctgl
轿	cjyn
辀	cns
辁	cve
辂	caol
较	cdvx
辄	cpl
辅	ctdd
辆	ctnv
辇	fvfc
辈	neec
辈	enec
辉	wwnc
辊	cbu
辋	cnvl
辌	cdom
辍	caaa
辎	csq
辏	cevy
辐	ctoq
辑	cop
辒	cbq
输	cvtn
辔	wcwo
辕	clok
辖	cnfo
辗	cphk
辘	cjzu
辙	cdga
辚	cxdi
辛	dxbs
辜	xodx
辝	godx
辞	jxox
辟	podx
辠	jgdx
辡	dxdx
辢	tomx
辣	dxtm
辤	jnax
辥	ujjx
辦	dxjx
辧	dxdx
辨	dxyx
辩	dxix
辪	ljpx
辫	dxwx
辬	dxdx
辭	jdnx
辮	dxwx
辯	dxix
辰	jfk
辱	jfkd
農	ujfk
辳	mmjk
辴	oobk
辵	sl
辶	zii
辷	tz
辸	zjz
边	jzcb
辺	dz
辻	xz
込	jnz
辽	jzcl
达	yzcd
辿	ez
迀	fz
迁	jxz
迂	fzcy
迃	fsz
迄	lzz
迅	zxz
迆	cz
过	xdzg
迈	thz
迉	pz
迊	tniz
迋	ez
迌	dz
迍	tulz
迎	cpz
迏	ydz
运	fgz
近	jjtz
迒	dwz
迓	cijz
返	jjaz
迕	lxz
迖	ydz
迗	tyz
还	jyz
这	dxz
迚	oiz
进	fnz
远	fwz
违	fjiz
连	czcl
迟	pnz
迠	yoz
迡	ptz
迢	doz
迣	hlz
迤	lcz
迥	noz
迦	joz
迧	biz
迨	goz
迩	rmz
迪	dzcd
迫	gzcp
迫	gzcb
迬	dez
迭	kvz
迮	lkz
迯	dyz
述	mdz
迱	ntz
迲	lgz
迳	ziz
迴	qoz
迵	ntoz
迶	xdz
迷	xzcm
迸	vhz
迹	dmzj
迺	cz
迻	ddz
迼	loz
追	jpzz
迾	tdnz
迿	sbz
退	ekz
送	vyz
适	jxoz
逃	vwvz
逄	aciz
逅	jjtz
逆	vujz
逇	lcz
逈	jnoz
选	jlwz
逊	zmz
逋	tdiz
逌	yqzz
逍	wdz
逎	uz
透	hzjz
逐	xzcz
逑	xxdz
递	vzsz
逓	jjfz
途	vtmz
逕	tsiz
逖	xjxz
逗	tovz
逘	glyz
這	iz
通	dnfz
通	ddiz
逛	xjez
逜	woz
逝	fjjz
逞	oez
速	tomz
造	jloz
逡	gvaz
逢	afz
連	cz
逤	smjz
逥	qnfz
逦	tndz
逧	vvoz
逨	xvvz
逨	tvvz
逩	yxhz
逪	hbz
逫	aaaz
逬	jfjz
逭	npzz
逮	eszd
逯	eszl
逰	flzz
週	nloz
進	tiz
逳	dgdz
逴	ybxz
逵	lvlz
逶	hrz
逷	bssz
逸	rowz
逹	lyz
逹	lvxz
逺	lykz
逻	qdz
逼	toqz
逽	hxoz
逾	vtdz
逿	btsz
逿	bjjz
遀	xidz
遁	jjxz
遂	vxz
遃	djsz
遄	ejnz
遅	pvfz
遆	dnnz
遇	bngz
遈	btlz
遉	ygvz
遊	dhlz
運	ncz
遌	oofz
遍	dpnz
過	qoz
遏	bsvz
遐	pfzz
遑	gez
遒	vuz
道	vjgz
達	lvfz
違	zioz
遖	xnyz
遖	xnvz
遗	qbz
遘	fntz
遙	dlxz
遚	giaz
遛	gdqz
遜	zjwz
遝	qsz
遝	qivz
遞	jjyz
遟	pdxz
遠	lokz
遡	vujz
遢	bjjz
遣	qpzz
遤	shz
遥	jlxz
遦	qxgz
遧	dbxz
遨	lhaz
適	dnxz
遪	gggz
遫	tomz
遬	tomz
遭	ubz
遮	jhhz
遯	dxz
遰	hwnz
遰	hnnz
遱	otoz
遲	pskz
遳	hvvz
遴	xdcz
遵	vuxz
遶	lllz
遷	cyez
選	eehz
遹	dtjz
遺	qgvz
遻	oovz
遼	yvbz
遽	yxz
遾	kivz
避	podz
邀	gdhz
邁	hbnz
邂	rdkz
邃	nvvz
還	qtoz
邅	dqoz
邆	xtoz
邇	tvnz
邈	jgwz
邉	jgnz
邊	jgnz
邋	sqxz
邌	hsjz
邍	aqez
邎	dijz
邏	qwmz
邐	tndz
邑	odly
邒	tp
邓	ap
邔	zlp
邕	sodl
邖	ep
邗	fpuh
邘	fp
邙	dlp
邚	rp
邛	ip
邜	dp
邝	jpuk
邞	fvp
邟	dwp
邠	vdp
邡	dhp
邢	thp
那	dfp
邤	jjtp
邥	plp
邦	fpub
邧	fwp
邨	tulp
邩	xp
邪	cijp
邫	fodl
邬	sstp
邭	sop
邮	dpuy
邯	hfp
邰	gop
邱	gpuq
邱	gpuc
邲	ujp
邳	jytp
邴	tnvp
邵	dops
邶	ktp
邷	tlzp
邸	ctvp
邹	rep
邺	wtp
邻	vjdp
邼	cep
邽	llp
邾	kmp
邿	lxdp
郀	yfsp
郁	xdpy
郂	dyvp
郃	vtop
郄	xxgp
郅	tglp
郆	lop
郇	sbp
郈	jjtp
郉	ffp
郊	dvxp
郋	jgp
郌	llol
郍	nsp
郎	degp
郏	tvvp
郐	vfgp
郑	vyp
郒	degl
郓	ncp
郔	jlzp
郕	jjxp
郖	tovp
郗	xxnp
郘	oop
郙	tdip
郚	wop
郛	jzp
郜	jlop
郝	lmp
郞	dekp
郟	yvvp
郟	tvvp
郠	tbxp
郡	ejop
郢	oep
郣	xnzp
郤	vvop
郥	gvp
郦	tndp
郧	obp
部	dopb
郩	xxdp
郪	teip
郫	gjxp
郬	ldp
郭	dozp
郮	nlop
郯	xxp
郰	pap
郱	vhp
郲	xvvp
郲	tvvp
郳	gwp
郴	mmp
郵	jxhp
郵	jtlp
郶	dool
郷	wjep
郸	vbxp
郹	gydp
郺	ddsl
郻	glsp
郼	ziop
都	ybp
郾	cbrp
郿	djgp
鄀	hxop
鄁	ktdp
鄂	oofp
鄃	vtdp
鄄	clp
鄅	jonp
鄆	ncp
鄇	tzlp
鄈	xtyp
鄉	wjdp
鄊	wjpp
鄋	giap
鄌	jeip
鄍	nbdp
鄎	jgup
鄏	jfkp
鄐	dwqp
鄑	twtp
鄒	sujp
鄓	jgyp
鄔	jztp
鄕	wjgp
鄖	ogvp
鄗	donp
鄘	jedp
鄙	oxqp
鄚	hbyp
鄛	sbmp
鄜	jznp
鄝	jjvp
鄞	holp
鄟	tbgp
鄠	ufsp
鄡	gmp
鄢	tlsp
鄣	dbxp
鄤	bqap
鄥	ghp
鄦	lhhp
鄧	xtop
鄨	vnml
鄩	eiop
鄪	zsnp
鄫	vqbp
鄬	jjjp
鄭	vuyp
鄮	gdgp
鄯	vfvp
鄰	xdcp
鄱	jxqp
鄲	oobp
鄳	qp
鄴	wtvp
鄵	ooop
鄶	vtqp
鄷	utop
鄸	hqnp
鄹	paxp
鄹	pajp
鄺	jhdp
鄻	fvfp
鄼	fvfp
鄽	jblp
鄾	jqfp
鄾	jnfp
鄿	hoop
酀	hokp
酀	hkop
酁	roup
酂	jlwp
酃	uoop
酄	hoop
酅	etip
酆	ffep
酇	jlwp
酈	tndp
酉	uyou
酉	uii
酊	ut
酋	vu
酌	usd
配	uzl
酎	uxd
酏	uc
酐	uf
酑	uf
酒	suuj
酓	vju
酔	uxx
酕	ujfl
酖	upl
酗	uxu
酘	uwa
酙	uddx
酚	uvd
酛	ufw
酜	ufv
酝	ufg
酞	uyd
酟	uyo
酠	uto
酡	unt
酢	ulk
酣	uhf
酤	uxo
酥	uh
酦	uyad
酧	unxd
酨	lux
酩	udo
酪	uao
酫	uve
酬	uyyy
酭	uxd
酮	unto
酯	utb
酰	ujlw
酱	kdu
酲	uoe
酳	uwd
酴	uvtm
酵	uyz
酶	ulqs
酷	ujlo
酸	ugva
酹	ujxd
酺	utdd
酻	ujz
酼	udgm
酽	utwj
酾	utnd
酿	udek
醀	uti
醁	ues
醂	umm
醃	uybl
醄	uslu
醅	udo
醆	uxx
醇	udoz
醈	uxx
醉	udvx
醊	uaaa
醋	uhb
醌	ubu
醍	ubtl
醎	ujtx
醏	uyb
醐	uxod
醑	ujld
醒	ubjl
醓	uplq
醔	hxu
醕	udob
醖	ubq
醗	uxtl
醗	uxth
醘	ulgq
醙	ugia
醚	uxz
醛	uhve
醜	ugwg
醝	uvfi
醞	uqvq
醟	xxnu
醠	unyq
醡	unvk
醢	uxoq
醣	ujeo
醤	kjxu
醥	ucfm
醦	uggs
醧	ucoo
醨	udxg
醩	uub
醪	ujjs
醫	clyu
醬	kdxu
醭	uwtv
醮	utih
醯	udgq
醰	ucbx
醱	uxza
醲	uujk
醳	uqly
醳	uqlx
醴	uutv
醵	uyx
醶	uvtv
醷	udbu
醸	udvk
醹	uujn
醺	ujth
醻	uljd
醼	uhoh
醼	uhkh
醽	uuoo
醾	ujmx
醿	ujmm
釀	udok
釁	jknd
釂	ujqd
釃	utnu
釄	ujme
釅	uooa
釆	jx
采	jmbc
釈	jxpn
釉	jxd
释	jxaf
釋	jxqy
釋	jxqx
里	blal
重	jtbl
野	bldt
量	btbl
釐	fmal
金	viij
釒	vii
釓	vvl
釔	vvz
釕	vvj
釖	vvd
釗	vvn
釘	vvt
釙	vvy
釚	vvx
釛	vvj
釜	vxfv
針	vvx
釞	vvjn
釟	vvv
釠	vvw
釡	vv
釢	vvzj
釣	vvsd
釤	vvs
釥	vvm
釦	vvo
釧	vvm
釨	vvz
釩	vvwd
釪	vvf
釫	vvfs
釬	vvf
釭	vvi
釮	vvxj
釯	vvdl
釰	vvdd
釱	vvy
釲	vve
釳	vvlz
釴	vvv
釵	vvad
釶	vvc
釷	vvl
釸	vvd
釹	vvr
釺	vvjx
釻	vvxd
釼	vvdn
釽	vvj
釾	vvcj
釿	vvjt
鈀	vvdl
鈁	vvdh
鈂	vvpl
鈃	vvth
鈄	vvdx
鈅	vvd
鈆	vvvg
鈇	vvfv
鈈	vvjy
鈉	vvnv
鈊	vvu
鈋	vvtt
鈌	vvzv
鈍	vvtl
鈎	vvsg
鈏	vvzi
鈐	vvvj
鈑	vvja
鈒	vvjn
鈓	vvjl
鈔	vvmj
鈕	vvjt
鈖	vvvd
鈗	vvgw
鈘	vvxa
鈙	vvya
鈚	vvu
鈛	vvx
鈜	vvxg
鈝	vvki
鈞	vvsv
鈟	vvzi
鈠	vvwa
鈡	vvoi
鈢	vvm
鈣	vvts
鈤	vvb
鈥	vvx
鈦	vvyd
鈧	vvdw
鈨	vvfw
鈩	vvdp
鈪	vvjc
鈫	vvdx
鈬	vvpn
鈭	ltv
鈮	vvpt
鈯	vvue
鈰	vvdi
鈱	vvpv
鈲	vvjn
鈳	vvto
鈴	vvvd
鈵	vvtv
鈶	vvgo
鈷	vvxo
鈸	vvxd
鈹	vvja
鈺	vved
鈻	vvpz
鈼	vvlk
鈽	vvxi
鈾	vvd
鈿	vvq
鉀	vvq
鉁	vvvs
鉂	vvox
鉃	vvly
鉄	vvkv
鉅	vvg
鉆	vvyo
鉇	vvlc
鉈	vvnt
鉉	vvdw
鉊	vvdo
鉋	vvse
鉌	vvh
鉍	vvuj
鉎	vvjl
鉏	vvqf
鉐	vvc
鉑	vvg
鉒	vvde
鉓	vvli
鉔	vvci
鉕	vvco
鉖	vvad
鉗	vvhf
鉘	vvzn
鉙	vvov
鉚	vvcp
鉛	vvwo
鉜	vvtd
鉝	vvd
鉞	vvcx
鉟	vvjt
鉠	vvny
鉡	vvvx
鉢	vvmt
鉣	vvlg
鉤	vvso
鉥	vvmd
鉦	vvtl
鉧	vvqs
鉨	vvrm
鉩	vvvm
鉪	vvhl
鉫	vvjo
鉬	vvg
鉭	vvbt
鉮	vvbi
鉯	vvlv
鉰	vvjo
鉱	vvjg
鉲	vvly
鉳	vvkt
鉴	nkv
鉵	vvq
鉶	vvtn
鉷	vvhv
鉸	vvdx
鉹	vvdd
鉺	vvp
鉻	vvao
鉼	vvvh
鉽	vvtv
鉾	vvgi
鉿	vvvo
銀	vvek
銁	vvsb
銂	vvyy
銃	vvdw
銄	vvjo
銅	vvno
銆	vvjb
銇	vvem
銈	vvll
銉	vvef
銊	vvjx
銋	vvtl
銌	vvxz
銍	vvtl
銎	iwdv
銏	vvnt
銐	tdnv
銑	vvjw
銒	vvff
銓	vvve
銔	vvjx
銕	vvtv
銖	vvkm
銗	vvjo
銘	vvdo
銙	vvys
銚	vvvv
銛	vvjo
銜	svfi
銝	vvtm
銞	sbv
銟	vvei
銠	vvyt
銡	vvlo
銢	vvfs
銣	vvro
銤	vvx
銥	vvdk
銦	vvqy
銧	vvww
銨	vvnr
銩	vvjg
銪	vvxd
銫	vvrl
銬	vvys
銭	vvex
銮	dmv
銯	vvwm
銰	vvhx
銱	vvoi
銲	vvbf
銳	vvvw
銴	fjjv
銵	vvr
銶	vvxd
銷	vvwd
銸	vvpl
銹	vvhj
銺	klv
銻	vvvj
銼	vvvl
銽	vvco
銾	vvis
銿	vvdf
鋀	vvtv
鋁	vvoo
鋂	vvls
鋃	vvdk
鋄	vvta
鋅	vvdx
鋆	lsvv
鋇	vvgv
鋈	sjyv
鋉	vvtm
鋊	vvvo
鋋	vvjz
鋌	vvjz
鋍	vvxz
鋎	vvnw
鋏	vvtv
鋐	vvng
鋑	vvga
鋒	vvaf
鋓	vvhn
鋔	vvrw
鋕	vvlu
鋖	vvjr
鋗	vvod
鋘	vvoy
鋙	vvwo
鋚	tiav
鋛	vvoi
鋜	vvol
鋝	vvjd
鋞	vvti
鋟	vvea
鋠	vvjk
鋡	vvvo
鋢	vvjz
鋣	vvcp
鋤	vvqj
鋥	vvoe
鋦	vvpo
鋧	vvgw
鋨	vvjx
鋩	vvhl
鋪	vvtd
鋫	hnv
鋬	fjjv
鋭	vvvw
鋮	vvjx
鋯	vvjo
鋰	vvbl
鋱	vvtv
鋲	vvgv
鋳	vvfd
鋴	vvxw
鋵	vvhw
鋶	vvdm
鋷	vvpa
鋸	vvpo
鋹	vvk
鋺	vvnc
鋻	gav
鋼	vvne
鋽	vvyx
鋾	vvsu
鋿	vvwo
錀	vvvh
錁	vvbm
錂	vvla
錃	sjav
錄	vvls
錅	hsjv
錆	vvld
錇	vvdo
錈	vvvc
錉	vvcb
錊	vvdx
錋	vvdd
錌	vvef
錍	vvgx
錎	vvrg
錏	vvtt
錐	vvti
錑	vvdd
錒	vvpo
錓	vvvl
錔	vvsb
錕	vvbu
錖	lmav
錗	vvhr
錘	vvjl
錘	vvjf
錙	vvsq
錚	vvri
錛	vvyh
錜	vvvu
錝	vvnm
錞	vvdz
錟	vvxx
錠	vvnl
錡	vvyo
錢	vvxx
錣	vvaa
錤	vvhv
錥	vvdd
錦	vvgi
錧	vvnz
錨	vvhq
錩	vvbb
錪	vvuv
錫	vvbs
錬	vvtm
錭	vvno
錮	vvqo
錯	vvhb
錰	vvmh
錱	vee
録	vves
錳	vvzq
錴	vvll
錵	vvht
錶	vvlk
錷	vvcl
錸	vvxv
錸	vvtm
錹	vvld
錺	vvhh
錻	vvfv
錼	vvym
錽	vvta
錾	cjjv
錿	vvyw
鍀	vvbd
鍁	vvjv
鍂	vvv
鍃	vvsu
鍄	vvdm
鍅	vvsg
鍆	vvn
鍇	vvug
鍈	vvhy
鍉	vvbl
鍊	vvtm
鍋	vvqo
鍌	sjlv
鍍	vvja
鍎	vvjg
鍏	vvzi
鍐	vvxa
鍑	vvla
鍒	vvdm
鍓	vvop
鍔	vvos
鍕	vvnc
鍖	vvhl
鍗	vvdi
鍘	vvgn
鍙	shvv
鍚	vvbs
鍛	vvja
鍜	vvpa
鍝	vvbg
鍞	vvyv
鍟	vvbl
鍠	vvge
鍡	vvqk
鍢	vvtq
鍣	vvho
鍤	vvjg
鍥	vvfy
鍦	vvdc
鍧	vvsi
鍨	vvxy
鍩	vvho
鍪	dtjv
鍫	hxv
鍬	vvhx
鍭	vvty
鍮	vvvn
鍯	vvsu
鍰	vvja
鍱	vvhm
鍲	vvpb
鍳	gkv
鍴	vven
鍵	vvez
鍶	vvqu
鍷	vvyl
鍸	vvxd
鍹	vvnt
鍺	vvyb
鍻	vvbl
鍼	vvjx
鍽	vvdh
鍾	vvjl
鍿	vvtq
鎀	vvts
鎁	vvpp
鎂	vvvy
鎃	vvsk
鎄	vvdk
鎅	vvqn
鎆	vvvn
鎇	vvdg
鎈	vvvi
鎉	vvbj
鎊	vvdh
鎋	vvno
鎌	vvvm
鎍	vvxm
鎎	vvkx
鎏	sdgv
鎐	vvju
鎑	vvlq
鎒	vvjd
鎓	vvvj
鎔	vvno
鎕	vvjo
鎖	vvwv
鎗	vvvo
鎘	vvty
鎙	vvvd
鎚	vvjz
鎛	vvtd
鎜	nswv
鎝	vvho
鎞	vvju
鎟	vvam
鎠	vvql
鎡	vvvw
鎢	vvjh
鎣	xxnv
鎤	vvbw
鎥	tiav
鎦	vvgq
鎧	vvev
鎨	vvtx
鎩	vvxa
鎪	vvga
鎫	vvja
鎬	vvdo
鎭	vvtv
鎮	vvxv
鎯	vvdp
鎰	vvvq
鎱	vvlk
鎲	vvww
鎳	vvjm
鎴	vvju
鎵	vvnx
鎶	vvto
鎷	vvsh
鎸	vvtj
鎹	vvvz
鎺	vvjf
鎻	vvsv
鎼	vvyf
鎽	vvef
鎾	vvbq
鎿	vvvf
鏀	vvyd
鏁	vvsm
鏂	vvco
鏃	vvdy
鏄	vvtd
鏅	vvtd
鏆	vvqv
鏇	vvdl
鏈	vvcz
鏉	vvtv
鏊	lhav
鏋	vvhd
鏌	vvhy
鏍	vvqm
鏎	vvbf
鏏	vvfe
鏐	vvjs
鏑	vvdo
鏒	vvgs
鏓	vvju
鏔	vvnv
鏕	vvju
鏖	jznv
鏗	vvgl
鏘	vvkd
鏙	vvei
鏚	vvjx
鏛	vvwi
鏜	vvwl
鏝	vvba
鏞	vvji
鏟	vvdl
鏠	vvaz
鏡	vvdw
鏢	vvcm
鏣	vvjh
鏤	vvor
鏥	vvnb
鏦	vvsl
鏧	ldjv
鏨	ccjv
鏩	vvct
鏪	vvub
鏫	vvhm
鏬	vvyi
鏭	vvju
鏮	vvjs
鏯	vvyx
鏰	vved
鏱	vvdx
鏲	vvdi
鏳	vvvb
鏴	vvoo
鏵	vvhf
鏶	vvtm
鏷	vvwv
鏸	vvtu
鏹	vvzq
鏺	vvxa
鏻	vvxi
鏼	vvkm
鏽	vvek
鏾	vvha
鏿	vvwm
鐀	vvqv
鐁	vvht
鐂	vvtq
鐃	vvlw
鐄	vvhv
鐅	vnmv
鐆	pvxv
鐇	vvjq
鐈	vvjo
鐉	vvev
鐊	vvps
鐋	vvss
鐌	vvrx
鐍	vvdo
鐎	vvth
鐏	vvvd
鐐	vvym
鐑	vvwo
鐒	vvxj
鐓	vvda
鐔	vvcx
鐕	vvcb
鐖	vvwx
鐗	vvnd
鐘	vvdl
鐙	vvxv
鐚	vvtu
鐛	vvbm
鐜	dozv
鐝	vvjv
鐞	vved
鐟	vvfb
鐠	vvvb
鐡	vvlx
鐢	mxxv
鐣	vvwf
鐤	vvgk
鐥	vvvo
鐦	vvnh
鐧	vvnb
鐨	vvzv
鐩	vvvz
鐪	vvyj
鐫	vvtm
鐬	vvlx
鐭	vvjy
鐮	vvjm
鐯	vvhb
鐰	vvom
鐱	vvvv
鐲	vvqq
鐳	vvuq
鐴	vvpx
鐵	vvlx
鐶	vvqk
鐷	vvhm
鐸	vvqy
鐸	vvqx
鐹	vvqz
鐺	vvwq
鐻	vvyx
鐼	vvxv
鐽	vvlz
鐾	podv
鐿	vvdu
鑀	vvja
鑁	vvda
鑂	vvjh
鑃	vvji
鑄	vvld
鑅	vvxm
鑆	vvwd
鑇	vvdh
鑈	vvtx
鑉	vvhq
鑊	vvha
鑋	cctv
鑌	vvnv
鑍	gvgv
鑎	vvcv
鑏	vvnt
鑐	vvun
鑑	vvgq
鑒	gkqv
鑓	vvqz
鑔	vvnm
鑕	vvjv
鑖	vvhx
鑗	vvhs
鑘	vvqq
鑙	vvhb
鑚	vvfv
鑛	vvjv
鑜	vvwv
鑝	vvhz
鑞	vvsv
鑟	vvlv
鑠	vvwm
鑡	vvlu
鑢	vvyu
鑣	vvjh
鑤	vvbs
鑥	vvrb
鑦	vvgv
鑧	vvnd
鑨	vvde
鑩	vveo
鑪	vvyq
鑫	vvv
鑬	vvgw
鑭	vvnm
鑮	vvhd
鑯	vvvx
鑰	vvvh
鑱	vvrd
鑲	vvdk
鑳	vvnl
鑴	vveo
鑵	vvhi
鑶	vvhx
鑷	vvpp
鑸	vvql
鑹	vvnv
鑺	vvgi
鑻	vvmf
鑼	vvqi
鑽	vvjv
鑾	wmiv
鑿	wtvv
钀	vvyd
钁	vvga
钂	vvwh
钃	vvpq
钄	vvhm
钅	vii
钆	vlug
钇	vz
针	vxuz
钉	vtud
钊	vnuz
钋	vyup
钌	vjul
钍	vlut
钎	vjx
钏	vm
钐	vsus
钑	vjzn
钒	vwdf
钓	vsd
钔	vnum
钕	vr
钖	vzs
钗	vad
钘	vth
钙	vtts
钚	vjy
钛	vydt
钜	vguj
钝	vtul
钞	vmj
钟	voiz
钠	vnv
钡	vb
钢	vnxg
钣	vjja
钤	vvj
钥	vduy
钦	vrv
钧	vsv
钨	vsst
钩	vsg
钪	vdw
钫	vdh
钬	vxuh
钭	vddx
钮	vjxt
钯	vdl
钰	ved
钱	vfx
钲	vtl
钳	vhf
钴	vxo
钵	vmt
钶	vtok
钷	vco
钸	vxni
钹	vxad
钺	vcx
钻	vyo
钼	vgum
钽	vbt
钾	vquj
钿	vqud
铀	vd
铁	vkv
铂	vgub
铃	vvjd
铄	vcm
铅	vwo
铆	vcjp
铇	vse
铈	vdni
铉	vdw
铊	vnt
铋	vuj
铌	vpt
铍	vja
铎	vafd
铏	vthn
铐	vys
铑	vyt
铒	vp
铓	vhdl
铔	vtwt
铕	vxd
铖	vjjx
铗	vtvv
铘	vcip
铙	vxtw
铚	vtgl
铛	vwe
铜	vnto
铝	voo
铞	voni
铟	vqy
铠	vezl
铡	vbn
铢	vkm
铣	vjlw
铤	vjlz
铥	vjlg
铦	vjxo
铧	vttx
铨	vve
铩	vxm
铪	vvto
铫	vvwv
铬	vao
铭	vdo
铮	vrei
铯	vrdl
铰	vdvx
铱	vdk
铲	vdj
铳	vdgw
铴	vszs
铵	vnr
银	vek
铷	vro
铸	vfxd
铹	vhnj
铺	vtdd
铻	vwo
铼	vtx
铽	vtuv
链	vcz
铿	vnal
销	vwdx
销	vwds
锁	vwb
锂	vbl
锃	voe
锄	vqfj
锅	vonv
锆	vjlo
锇	vjfx
锈	vhzj
锉	vvvl
锊	vjxd
锋	vaff
锌	vdx
锍	vdgm
锎	vnth
锏	vnb
锐	vvow
锑	vvzj
锒	vdek
锓	vena
锔	vpjo
锕	vpto
锖	vld
锗	vyb
锘	vhxo
错	vhb
锚	vhq
锛	vyxh
锜	vyto
锝	vbtd
锞	vbm
锟	vbu
锠	vbb
锡	vbss
锢	vqxo
锣	vqd
锤	vjxf
锥	vti
锦	vgni
锧	vjjb
锨	vjjv
锩	vvyc
锪	vssu
锫	vdo
锬	vxx
锭	vntl
键	vefz
锯	vpxo
锰	vzq
锱	vsq
锲	vfdy
锳	vhny
锴	vug
锵	vkdd
锶	vqu
锷	voos
锸	vjxg
锹	vhx
锺	vjtl
锻	vjia
锼	vgia
锽	vge
锾	vjfa
锿	vdok
镀	vjha
镁	vvey
镂	vxr
镃	vvww
镄	vzsb
镅	vdjg
镆	vhby
镇	vxqv
镈	vtdd
镉	vtoy
镊	vpaa
镋	vwnw
镌	vtij
镍	vjgm
镎	vvtf
镏	vgdq
镐	vdoo
镑	vdnh
镒	vvvq
镓	vnxj
镔	vngv
镕	vnvo
镖	vcfm
镗	vwnl
镘	vbqa
镙	vqwm
镚	vedd
镛	vjei
镜	vdbw
镝	vdno
镞	vdhy
镟	vdhl
镠	vjjs
镡	vcbx
镢	vjvv
镣	vyvm
镤	vwtv
镥	vrtb
镦	vdoa
镧	vntm
镨	vvwb
镩	vnvi
镪	vzsq
镫	vxtv
镬	vhta
镭	vuq
镮	vqtk
镯	vqsq
镰	vjvm
镱	vdbu
镲	vnxm
镳	vjzh
镴	vsqv
镵	vrod
镶	vdok
長	kii
镸	kii
镹	krn
镺	kjy
镻	kkv
镼	kpue
镽	kyvm
镾	ktvx
长	kiic
門	nii
閁	nnj
閂	nnt
閃	nnv
閄	nnv
閅	nnt
閆	nne
閇	nntd
閈	nnf
閉	nnxj
閊	nne
開	nnth
閌	nndw
閍	nndh
閎	nnxg
閏	nne
閐	nnjl
閑	nnm
閒	nnd
間	nnb
閔	nndx
閕	nncj
閖	nns
閗	nndx
閘	nnq
閙	nndi
閚	nnd
閛	nnti
閜	nnto
閝	nnvd
閞	nngh
閟	nnuj
閠	nned
閡	nndv
関	nnvy
閣	nnao
閤	nnvo
閥	nntx
閦	nnvv
閧	nnhv
閨	nnll
閩	nnq
閪	nnc
閫	nnqm
閬	nndk
閭	nnoo
閮	nnjz
閯	nnsj
閰	nng
閱	nnvw
閲	nnvw
閳	nnc
閴	nngv
閵	nnti
閶	nnbb
閷	xmnv
閸	nntt
閹	nnyl
閺	nnbx
閻	nnrg
閼	nndd
閽	nncb
閾	nntx
閿	nnja
闀	nnhe
闁	nnn
闂	nnvc
闃	nngd
闄	nncr
闅	nnga
闆	nnoo
闇	nndb
闈	nnzi
闉	nncl
闊	nnso
闋	nnxy
闌	nntm
闍	nnyb
闎	nngs
闏	nnwq
闐	nnxv
闑	nnjm
闒	nnbj
闓	nnev
闔	nnlq
闕	nnvv
闖	nnsh
闗	nnwh
闘	nntd
闙	nndo
闚	nnfw
闛	nnwl
關	nnwh
闝	nnga
闞	nnja
闟	nnvj
闠	nnqv
闡	nnox
闢	nnpx
闣	nnwq
闤	nnqk
闥	nnlz
闦	nnuv
闧	nnlz
门	niim
闩	ntcs
闪	nvcs
闫	necy
闬	nf
闭	nxj
问	nocw
闯	nst
闰	necr
闱	nfji
闲	nmcx
闲	nmcs
闳	nxg
间	nb
闵	ndxm
闶	ndw
闷	nucm
闸	nqcz
闹	ndni
闺	nll
闻	npcw
闼	nyz
闽	nqcm
闾	nool
闿	nezl
阀	ntx
阁	naog
阂	ndyv
阃	nqm
阄	nrbl
阅	nvow
阆	ndek
阇	nyb
阈	ntox
阉	nybl
阊	nbb
阋	ngw
阌	njna
阍	nctb
阎	nrg
阏	ndhd
阐	nvbx
阑	ntqm
阒	ngyd
阓	nqb
阔	nsjo
阕	nxty
阖	nlgq
阗	nxqv
阘	nbjj
阙	nvuv
阚	njpa
阛	nqtk
阜	jpzx
阝	pii
阞	pj
队	pv
阠	pzx
阡	pjx
阢	ptw
阣	plz
阤	pc
阥	ps
阦	px
阧	pddx
阨	pjc
阩	pjh
阪	pjja
阫	pjy
阬	pdw
阭	pgw
阮	pfw
阯	pl
阰	pu
阱	pfn
防	pdh
阳	pb
阴	pduy
阵	pcuz
阶	pvn
阷	ptl
阸	pdpz
阹	plg
阺	pctd
阻	pqf
阼	plk
阽	pyo
阾	pvjd
阿	pto
陀	pntt
陁	plc
陂	pja
陃	ptnv
附	ptxd
际	pfm
陆	pfu
陇	pxtd
陈	ptm
陉	pzi
陊	pdd
陋	ptnl
陌	pjb
降	paci
陎	pkm
陏	pxd
限	pek
陑	pjnn
陒	prjc
陓	pyfs
陔	pdyv
陕	ptvv
陖	pgva
陗	pwd
陘	ptsi
陙	pjfk
陚	pflv
陛	pul
陜	pyvv
陜	ptvv
陝	ptjv
陞	pjhl
陟	py
陠	ptdd
陡	pll
院	pnfw
陣	pc
除	pvtm
陥	prib
陦	pfxd
陧	pbl
陨	pob
险	pvtw
陪	pdo
陫	pnee
陫	pene
陬	ppa
陭	pyto
陮	pti
陯	pvth
陰	pvjg
陱	psx
陲	pjxf
陲	pjtl
陳	ptbm
陴	pgjx
陵	plva
陶	pslu
陷	prg
陸	plvl
陹	pjhb
険	pvtv
陻	pcl
陼	pyb
陽	pbts
陽	pbjs
陾	pjny
陿	pctv
隀	pjtl
隁	pcbr
隂	pvk
隃	pvtn
隄	pbtl
隅	pbng
隆	patl
隇	pjtx
隈	pqtk
隉	pgi
隊	pvx
隋	pxid
隌	pdb
隍	pge
階	pug
随	pxdz
隐	preu
隑	petv
隒	pvem
隓	pxii
隔	ptoy
隕	pogv
隖	pjzh
隗	pgwg
隘	pvvq
隙	pmbm
隚	pwnl
際	pxfm
障	pdbx
隝	pgh
隞	plha
隟	psbm
隠	pjeu
隡	pdjl
隢	pllw
隣	pxdi
隤	pqgv
隥	pxtv
隦	ppox
隧	pvxz
隨	pxiz
隩	pjny
險	pvtv
隫	pxhv
隬	ptvx
隭	pujn
隮	pddh
隯	pljd
隰	pbwh
隱	pjiu
隲	pmjh
隳	pxid
隴	pdde
隵	pytx
隶	esal
隷	lfms
隸	mfms
隹	ti
隺	pii
隻	tia
隼	tix
隽	tizj
难	ati
隿	vti
雀	mjii
雁	jtti
雂	vjti
雃	thti
雄	xgti
雅	ciji
集	tim
雇	dpti
雈	hti
雉	lyti
雊	soti
雋	tim
雌	ltti
雍	dwji
雎	qfti
雏	reti
雐	yti
雑	xmti
雒	aoti
雓	vtmi
雔	titi
雕	nloi
雖	oqti
雗	xbxi
雘	ndha
雙	tita
雚	hooi
雛	suji
雜	dvvi
雝	sodi
雞	jwyi
雟	ujto
雠	tiii
雡	jjvi
離	dxui
難	hofi
雤	jkxi
雥	titi
雦	titi
雧	titm
雨	uiiy
雩	ufs
雪	uebx
雪	uebs
雫	utd
雬	um
雭	ujzn
雮	ujfl
雯	udx
雰	uvd
雱	udh
雲	ufg
雳	ujj
雴	ud
雵	uny
零	uvjd
雷	uq
雸	uhf
雹	use
雺	udtj
電	ubl
雼	uc
雽	ujvi
雾	uaj
雿	uvwv
需	ujnn
霁	udxn
霂	usm
霃	uspl
霄	uwd
霅	ui
霆	ujlz
震	ujfk
霈	usti
霉	ulqs
霊	ufwt
霋	uter
霌	unlo
霍	uti
霎	udr
霏	uene
霐	uszg
霑	usyo
霒	ufgj
霓	ugw
霔	usde
霕	ufgl
霖	umm
霗	usvd
霘	usno
霙	uhny
霚	udta
霛	uzss
霜	umg
霝	uooo
霞	upfa
霟	ushv
霠	udvj
霡	uddx
霢	udjk
霣	uogv
霤	ugdq
霥	unfx
霦	umms
霧	udtj
霨	upfd
霩	udop
霪	usjl
霫	ujjg
霬	uqhv
霭	uibl
霮	ushl
霯	uxtv
霰	uhda
霱	udto
露	uolo
霳	upal
霴	ufgs
霵	uopx
霶	usdh
霷	ubbs
霸	uhpd
霹	upox
霺	usea
霻	uutv
霼	ufgx
霽	uddh
霾	ujbl
霿	udtg
靀	uhnx
靁	uqqq
靂	ujhl
靃	utii
靄	uibl
靅	ufgv
靆	ufgz
靇	udde
靈	uoov
靉	ufga
靊	uffv
靋	usjl
靌	unev
靍	utih
靎	uvgh
靏	upih
靐	uquq
靑	lnl
靑	lnit
青	ldbq
青	ldbc
靓	ldnw
靔	ldkz
靕	tlld
靖	dldj
靗	ldww
靘	ldrl
静	ldri
靚	ldgw
靛	ldnl
靜	ldji
靝	ldkx
非	nee
非	enef
靟	neel
靟	enel
靠	jloe
靡	jmme
面	jqnf
靣	jqo
靤	jqne
靥	jydf
靦	jqnw
靧	jqnv
靨	jbdf
革	hpbg
靪	hpt
靫	hpad
靬	hpf
靭	hpdd
靮	hpsd
靯	hpl
靰	hptw
靱	hpdn
靲	hpvj
靳	hpjt
靴	hptt
靵	hpjt
靶	hpdl
靷	hpzi
靸	hpjn
靹	hpnv
靺	hptm
靻	hpqf
靼	hpbt
靽	hpvx
靾	hphl
靿	hpwj
鞀	hpdo
鞁	hpja
鞂	hph
鞃	hpzg
鞄	hpse
鞅	hpny
鞆	hptv
鞇	hpqy
鞈	hpvo
鞉	hpvv
鞊	hplo
鞋	hpll
鞌	nrhp
鞍	hpnr
鞎	hpek
鞏	iwdp
鞐	hpld
鞑	hpyz
鞒	hpjn
鞓	hpoe
鞔	hprw
鞕	hptx
鞖	hpjr
鞗	tiap
鞘	hpwd
鞙	hpod
鞚	hpni
鞛	hpdo
鞜	hpsb
鞝	hpwo
鞞	hpgx
鞟	hpdz
鞠	hpsx
鞡	hpfd
鞢	hphm
鞣	hpdm
鞤	llxp
鞥	hpvh
鞦	hphx
鞧	hpvu
鞨	hpbl
鞩	hpwn
鞪	dtjp
鞫	hpsi
鞬	hpez
鞭	hptx
鞮	hpbl
鞯	hphz
鞰	hpbq
鞱	hpjg
鞲	hpfl
鞳	hpho
鞴	hphi
鞴	hphf
鞵	hpjy
鞶	nswp
鞷	tonp
鞸	hpbf
鞹	hpdp
鞺	hpwl
鞻	hpor
鞼	hpqv
鞽	hpjo
鞾	hphf
鞿	hpwx
韀	hpjh
韁	hptt
韂	hpri
韃	hplz
韄	hpha
韅	hpbh
韆	hpcz
韇	hplv
韈	hphx
韉	hphh
韊	hphm
韋	zioi
韌	ziod
韍	ziod
韎	ziom
韏	vyzi
韐	zioo
韑	wwzi
韒	ziod
韓	xbxi
韔	ziok
韕	zioz
韖	ziom
韗	zioc
韘	ziom
韙	btli
韚	ziop
韛	ziof
韜	ziog
韝	ziol
韞	zioq
韟	ziox
韠	ziof
韡	ziof
韢	ziou
韣	zioq
韤	ziox
韥	ziov
韦	fji
韧	fjid
韨	fjia
韩	xbxi
韪	btli
韫	fjiq
韬	fjig
韭	neet
韭	enet
韮	hnet
韮	hent
韯	lnex
韯	lenx
韰	ydat
韱	vvtx
韲	ddyt
音	db
韴	dbti
韵	dbsv
韶	dbdo
韷	dbue
韸	dbaf
韹	dbge
韺	dbhy
韻	dbov
韼	dbaz
韽	vjub
韾	ldjb
響	wjdb
頀	dbha
頁	jgv
頂	tjgv
頃	tljv
頄	xjgv
項	ijgv
順	mjgv
頇	fjgv
須	sjgv
頉	ljgv
頊	ejgv
頋	jcjv
頌	vgjv
頍	xajv
頎	jjtv
頏	dwjv
預	dtjv
頑	fwjv
頒	vdjv
頓	tulv
頔	djgv
頕	yojv
頖	vxjv
頗	jajv
領	vjdv
頙	tljv
頚	aljv
頛	emjv
頜	vtov
頝	dvxv
頞	nrjv
頟	aojv
頠	rjcv
頡	lojv
頢	jxov
頣	gjgv
頤	gjgv
頥	igjv
頦	dyvv
頧	jpzv
頨	jjjv
頩	vhjv
頪	xjgv
頫	vwvv
頬	tvvv
頭	tovv
頮	shjv
頯	dhjv
頰	yvvv
頰	tvvv
頱	jxdv
頲	jlzv
頳	lmjv
頴	tfmv
頵	ejov
頶	jlov
頷	vjov
頸	tsiv
頹	hwjv
頺	hzjv
頻	yjgv
頼	tomv
頽	hwjv
頾	sjgt
頿	sltv
顀	tijv
顁	ntlv
顂	xvvv
顂	tvvv
顃	xxjv
顄	jxuv
顅	dpdv
顆	bmjv
顇	dvvv
顈	twmv
顉	vvjv
顊	jpzv
顋	qujv
題	btlv
額	naov
顎	oofv
顏	dxjv
顐	ncjv
顑	jtov
顒	bngv
顓	ejnv
顔	djsv
顕	bwtv
顖	jqxv
顗	etov
願	jgmv
顙	aaav
顚	tglv
顛	xqev
顜	fntv
顝	qdjv
類	xydv
顟	jjvv
顠	cfmv
顡	dxjv
顢	hniv
顣	jlmv
顤	lllv
顥	bdov
顦	tihv
顧	dptv
顨	jgvn
顩	vtov
顪	ljtv
顫	dqov
顬	ujnv
顭	hqnv
顮	ntjv
顮	ntiv
顯	bwwv
顰	yjgx
顱	yqqv
顲	xxdv
顳	pppv
顴	hoov
页	jbby
顶	tjbd
顷	tljb
顸	fjb
项	ijb
顺	mjbs
须	sjbx
须	sjbs
顼	ejb
顽	fwjb
顾	jcjb
顿	tulb
颀	jjtb
颁	vdjb
颂	vgjb
颃	dwjb
预	dtjb
颅	ypjb
领	vjdb
颇	jajb
颈	zijb
颉	lojb
颊	tvvb
颋	jlzb
颌	vtob
颍	tsjb
颎	txjb
颏	dyvb
颐	gjb
频	yjb
颒	shjb
颓	hwjb
颔	vjob
颕	tfmb
颖	thjb
颗	bmjb
题	btlb
颙	bngb
颚	oofb
颛	ejnb
颜	djsb
额	naob
颞	paab
颟	htnb
颠	xqeb
颡	aaab
颢	bdob
颣	xwmb
颤	dqob
颥	ujnb
颦	yjbx
颧	hoob
風	wjq
颩	wjqs
颪	tdwq
颫	wjqv
颬	wjqj
颭	wjqo
颮	wjqe
颯	dwjq
颰	wjqa
颱	wjqo
颲	wjqn
颳	wjqo
颴	wjql
颵	wjqd
颶	wjqv
颷	wjqx
颸	wjqu
颹	wjqi
颺	wjqs
颻	jlxq
飌	hooq
飍	wjqq
风	wx
飏	wxzs
飐	wxyo
飑	wxse
飒	dwx
飓	wxqv
飔	wxqu
飕	wxga
飖	jlxx
飗	wxgq
飘	cfmx
飙	ydyx
飚	wxxx
飛	zvjv
飜	jxqv
飝	zvjv
飞	zvaf
食	vdek
飠	vdeg
飡	vvdk
飢	vdew
飣	vdet
飤	vdev
飥	vdet
飦	vdef
飧	dvdk
飨	wjvk
飩	vdel
飪	vdel
飫	vdey
飬	vydk
飭	vdej
飮	vdev
飯	vdea
飰	vdey
飱	tdvk
飲	vdev
飳	vdee
飴	vdeo
飵	vdek
飶	vdej
飷	vdef
飸	otsk
飹	vdep
飺	ltvk
飻	vdes
飼	vdeo
飽	vdee
飾	vdei
飿	vdee
餀	vdex
餁	vdel
餂	vdeo
餃	vdex
餄	vdeo
餅	vdeh
餆	vdev
餇	vdeo
餈	vrvk
餉	vdeo
養	vfvk
養	vevk
餋	vyvk
餌	vdep
餍	jydk
餎	vdeo
餏	vdek
餐	ydak
餑	vdez
餒	vder
餓	vdex
餔	vded
餕	vdea
餖	vdev
餗	vdem
餘	vdem
餙	vdei
餚	vded
餛	vdeu
餜	vdem
餝	vdeh
餞	vdex
餟	vdea
餠	vdef
餡	vdeg
餢	vdeo
餣	vdel
餤	vdex
餥	neek
餥	enek
餦	vdek
餧	vder
館	vdez
餩	vdev
餪	vdey
餫	vdec
餬	vded
餭	vdee
餮	tdvk
餯	vdex
餰	vdei
餱	vdey
餲	vdel
餳	vdes
餴	vdeh
餵	vdek
餶	vded
餷	vdet
餸	vdez
餹	vdeo
餺	vded
餻	vdeh
餼	vdex
餽	vdeg
餾	vdeq
餿	vdea
饀	vdeg
饁	vdeq
饂	vdeq
饃	vdey
饄	vdel
饅	vdea
饆	vdef
饇	vdeo
饈	vdet
饉	vdel
饊	vdea
饋	vdev
饌	vdev
饍	vdeo
饎	vdeo
饏	jpak
饐	vdev
饑	vdex
饒	vdew
饓	vdem
饔	dwjk
饕	otsk
饖	vdex
饗	wjdk
饘	vdet
饙	vdev
饚	vdeq
饛	vdex
饜	jbdk
饝	vdec
饞	vded
饟	vdek
饠	vdei
饡	vdev
饢	vdek
饣	rl
饤	rlt
饥	rlw
饦	rljt
饧	rlzs
饨	rltl
饩	rlkz
饪	rljl
饫	rljy
饬	rllj
饭	rlja
饮	rlrv
饯	rlfx
饰	rlli
饱	rlse
饲	rljo
饳	rlue
饴	rlgo
饵	rlp
饶	rlxw
饷	rljo
饸	rlvo
饹	rlao
饺	rldx
饻	rldk
饼	rlvh
饽	rlxz
饾	rltv
饿	rljx
馀	rlvm
馁	rljr
馂	rlga
馃	rlbm
馄	rlbu
馅	rlrg
馆	rlnz
馇	rlmt
馈	rlqb
馉	rlqd
馊	rlga
馋	rlrd
馌	rllq
馍	rlhy
馎	rltd
馏	rlgq
馐	rlvt
馑	rlhl
馒	rlba
馓	rlha
馔	rlev
馕	rltk
首	vjg
馗	xvjg
馘	vjgx
香	hbbs
馚	hbvd
馛	hbxa
馜	hbpt
馝	hbuj
馞	hbxz
馟	hbjz
馠	hbvo
馡	hbne
馡	hbee
馢	hbxx
馣	hbyl
馤	hbbl
馥	hbla
馦	hbvm
馧	hbbq
馨	ldjb
馩	hbxv
馪	hbnv
馫	hbhb
馬	sh
馭	sha
馮	vsh
馯	shf
馰	shsd
馱	shy
馲	shjt
馳	shc
馴	shm
馵	shh
馶	shxa
馷	shti
馸	shjt
馹	shb
馺	shjn
馻	shgw
馼	shdx
馽	shoi
馾	shpl
馿	shdp
駀	shxd
駁	shxx
駂	txsh
駃	shzv
駄	shyd
駅	shpn
駆	shcx
駇	sha
駈	shg
駉	shno
駊	shja
駋	shdo
駌	dcsh
駍	shti
駎	shd
駏	shg
駐	shde
駑	rash
駒	shso
駓	shjt
駔	shqf
駕	josh
駖	shvd
駗	shvs
駘	shgo
駙	shtd
駚	shny
駛	shox
駜	shuj
駝	shnt
駞	shlc
駟	shq
駠	shcp
駡	oosh
駢	shvh
駣	shvv
駤	shtl
駥	shtx
駦	vysh
駧	shno
駨	shsb
駩	shve
駪	shjw
駫	shww
駬	shp
駭	shdv
駮	shdx
駯	shkm
駰	shqy
駱	shao
駲	shyy
駳	shjz
駴	shtx
駵	shtz
駶	shpo
駷	shtm
駸	shea
駹	shxd
駺	shdk
駻	shbf
駼	shvm
駽	shod
駾	shvw
駿	shga
騀	shjx
騁	shds
騂	shdx
騃	shgy
騄	shes
騅	shti
騆	shno
騇	shvo
騈	shjf
騉	shbu
騊	shsu
騋	shxv
騋	shtm
騌	shnm
騍	shbm
騎	shyo
騏	shhv
騐	shvu
騑	shne
騑	shee
騒	shaq
験	shvv
騔	shbl
騕	shcr
騖	dtjh
騗	dpnh
騘	shsu
騙	shdh
騚	shvn
騛	shzv
騜	shge
騝	shez
騞	shfc
騟	shvn
騠	shbl
騡	shgs
騢	shpa
騣	shxa
騤	shxy
騥	shdm
騦	shqu
騧	shqo
騨	shwx
騩	shgg
騪	shga
騫	nfnh
騬	shjv
騭	pysh
騮	shgq
騯	shdh
騰	dvyh
騱	shjy
騲	shhx
騳	shsh
騴	shbr
騵	shjm
騶	shsj
騷	shaq
騸	shdj
騹	shhl
騺	lyxh
騺	lvxh
騻	shyx
騼	shju
騽	shjg
騾	shqm
騿	shdx
驀	hbyh
驁	lhah
驂	shgs
驃	shcm
驄	shju
驅	shco
驆	shbf
驇	lvlh
驈	shdo
驉	shyt
驊	shhf
驋	shxa
驌	shek
驍	shlw
驎	shxi
驏	shpz
驐	shda
驑	shtq
驒	shox
驓	shvb
驔	shcx
驕	shjo
驖	shlx
驗	shvv
驘	dloh
驘	dlod
驙	shdt
驚	hsoh
驛	shqy
驛	shqx
驜	shwm
驝	shlm
驞	shnv
驟	shpx
驠	shhh
驡	ddth
驡	ddsh
驢	shyq
驣	shvh
驤	shdk
驥	shkv
驦	shug
驧	shhx
驨	sheo
驩	shhi
驪	shtu
驫	shsh
马	stam
驭	sta
驮	sty
驯	stmx
驯	stms
驰	stc
驱	stcx
驲	stb
驳	stxx
驴	stdp
驵	stqf
驶	stox
驷	stq
驸	sttd
驹	stso
驺	stre
驻	stde
驼	stnt
驽	rast
驾	jost
驿	staf
骀	stgo
骁	stxw
骂	oost
骃	stqy
骄	stjn
骅	sttx
骆	stao
骇	stdv
骈	stvh
骉	stst
骊	sttd
骋	stds
验	stvw
骍	stdx
骎	stea
骏	stga
骐	sthv
骑	styo
骒	stbm
骓	stti
骔	stnm
骕	sten
骕	stei
骖	stgs
骗	stdh
骘	pyst
骙	stxy
骚	staq
骛	dtjt
骜	lhat
骝	stgq
骞	nfnt
骟	stdj
骠	stcm
骡	stqm
骢	stju
骣	stpz
骤	stpx
骥	stkv
骦	stug
骧	stdk
骨	qd
骩	qdx
骪	qdwd
骫	qdxd
骬	qdf
骭	qdf
骮	qdv
骯	qddw
骰	qdwa
骱	qdvn
骲	qdse
骳	qdja
骴	qdlt
骵	qdmt
骶	qdcd
骷	qdxo
骸	qddv
骹	qddx
骺	qdjo
骻	qdys
骼	qdao
骽	qdjr
骾	qdtx
骿	qdvh
髀	qdgx
髁	qdbm
髂	qdno
髃	qdbg
髄	qdxz
髅	qdxr
髆	qdtd
髇	qddo
髈	qddh
髉	qdpi
髊	qdvi
髋	qdnw
髌	qdnv
髍	qdjm
髎	qdjs
髏	qdor
髐	qdlw
髑	qdqq
髒	qdhh
髓	qdxz
體	qduv
髕	qdnv
髖	qdnd
髗	qdyq
高	dono
髙	dnfo
髚	donw
髛	donx
髜	donh
髝	donj
髞	donm
髟	ks
髠	ksw
髡	kstw
髢	ksc
髣	ksdh
髤	ksm
髥	ksnf
髦	ksjl
髧	kspl
髨	ksfw
髩	kstj
髪	ksxa
髫	ksdo
髬	ksjt
髭	kslt
髮	ksxd
髯	ksnl
髰	kshl
髱	ksse
髲	ksja
髳	ksdj
髴	kszn
髵	ksjn
髶	ksp
髷	ksu
髸	kshv
髹	kstm
髺	ksjo
髻	kslo
髼	ksaf
髽	ksvl
髾	kswd
髿	kssj
鬀	ksvj
鬁	kshn
鬂	ksgv
鬃	ksnm
鬄	ksbs
鬅	ksdd
鬆	ksmg
鬇	ksri
鬈	ksvc
鬉	ksxa
鬊	kseb
鬋	ksvn
鬌	ksxd
鬍	ksxd
鬎	kstn
鬏	kshx
鬐	ksyb
鬑	ksvm
鬒	ksxv
鬓	ksnv
鬔	ksaz
鬕	kshy
鬖	ksgs
鬗	kshd
鬘	ksba
鬙	ksvb
鬚	kssv
鬛	ksqv
鬜	ksnd
鬝	ksnb
鬞	ksuk
鬟	ksqk
鬠	ksvb
鬡	ksnt
鬢	ksnv
鬣	kssv
鬤	ksdk
鬥	ieei
鬥	eiei
鬦	eiex
鬧	eiei
鬨	eiev
鬩	eiew
鬪	eied
鬫	eiea
鬬	eiet
鬭	eiet
鬮	eiex
鬮	eieq
鬮	eiel
鬯	xddt
鬯	dxdt
鬰	mxxs
鬱	mlxs
鬲	tony
鬳	ytoy
鬴	tond
鬵	cwcy
鬶	fvny
鬷	tona
鬸	tonq
鬹	fvgy
鬺	tons
鬻	zsxy
鬼	gwg
鬽	gwgs
鬾	gwga
鬿	gwgt
魀	gwgn
魁	gwgx
魂	fggg
魃	gwgd
魄	ggwg
魅	gwgm
魆	gwgx
魇	jydg
魈	gwgd
魉	gwgv
魊	gwgx
魋	gwgi
魌	gwgv
魍	gwgl
魎	gwgd
魏	hrgg
魐	gwgm
魑	gwgg
魒	gwgm
魓	gwgf
魔	jmmg
魕	gwgx
魖	gwgt
魗	ljig
魘	jbdg
魙	scjg
魚	rh
魛	rhd
魜	rhv
魝	rhn
魞	rhjn
魟	rhi
魠	rhjt
魡	rhsd
魢	rhzl
魣	rhdt
魤	rhtt
魥	rhjn
魦	rhmj
魧	rhdw
魨	rhtl
魩	rhss
魪	rhvn
魫	rhpl
魬	rhja
魭	rhfw
魮	rhu
魯	rhb
魰	rhdx
魱	rhtt
魲	rhdp
魳	rhti
魴	rhdh
魵	rhvd
魶	rhnv
魷	rhxd
魸	rhk
魹	rhjl
魺	rhto
魻	rhq
魼	rhlg
魽	rhhf
魾	rhjt
魿	rhvd
鮀	rhnt
鮁	rhxd
鮂	rhqv
鮃	rhti
鮄	rhzn
鮅	rhuj
鮆	ltrh
鮇	rhfm
鮈	rhso
鮉	rhdo
鮊	rhg
鮋	rhd
鮌	rhdw
鮍	rhja
鮎	rhyo
鮏	rhjl
鮐	rhgo
鮑	rhse
鮒	rhtd
鮓	rhlk
鮔	rhg
鮕	rhxo
鮖	rhc
鮗	rhad
鮘	rhtv
鮙	rhjj
鮚	rhlo
鮛	rhlm
鮜	rhjo
鮝	vyrh
鮞	rhjn
鮟	rhnr
鮠	rhrc
鮡	rhvv
鮢	rhkm
鮣	rhep
鮤	tdnh
鮥	rhao
鮦	rhno
鮧	rhtv
鮨	rhtb
鮩	rhvh
鮪	rhxd
鮫	rhdx
鮬	rhys
鮭	rhll
鮮	rhvf
鮯	rhvo
鮰	rhqo
鮱	rhyt
鮲	rhtd
鮳	rhys
鮴	rhtm
鮵	rhvw
鮶	rheo
鮷	rhvj
鮸	rhrw
鮹	rhwd
鮺	vfrh
鮻	rhga
鮼	rhea
鮽	rhvm
鮾	rhjr
鮿	rhpl
鯀	rhjm
鯁	rhtx
鯂	rhu
鯃	rhwo
鯄	rhxd
鯅	rhjz
鯆	rhtd
鯇	rhnw
鯈	tiah
鯉	rhbl
鯊	smjh
鯋	rhsj
鯌	rhjo
鯍	rhdm
鯎	rhjx
鯏	rhhn
鯐	rhll
鯑	rhxi
鯒	rhdi
鯒	rhdf
鯓	rhr
鯔	rhsq
鯕	rhhv
鯖	rhld
鯗	vfvh
鯗	vevh
鯘	rhhr
鯙	rhdz
鯚	rhhz
鯛	rhno
鯜	rhdr
鯝	rhqo
鯞	rhei
鯟	rhtm
鯠	rhxv
鯠	rhtm
鯡	rhne
鯡	rhee
鯢	rhgw
鯣	rhbs
鯤	rhbu
鯥	rhll
鯦	rhao
鯧	rhbb
鯨	rhdm
鯩	rhvh
鯪	rhla
鯫	rhpa
鯬	hsjh
鯭	rhzq
鯮	rhnm
鯯	rhkn
鯰	rhvu
鯱	rhyw
鯲	rhdd
鯳	rhjd
鯴	rhzq
鯵	rhgs
鯶	rhnc
鯷	rhbl
鯸	rhty
鯹	rhbl
鯺	rhyb
鯻	rhtn
鯼	rhxa
鯽	rhep
鯾	rhtx
鯿	rhdh
鰀	rhja
鰁	rhgs
鰂	rhgn
鰃	rhqk
鰄	rhjx
鰅	rhbg
鰆	rheb
鰇	rhdm
鰈	rhhm
鰉	rhge
鰊	rhtm
鰋	rhcr
鰌	rhvu
鰍	rhhx
鰎	rhez
鰏	rhtq
鰐	rhos
鰑	rhbs
鰒	rhla
鰓	rhqu
鰔	rhjx
鰕	rhpa
鰖	rhxd
鰗	rhxd
鰘	rhnl
鰙	rhho
鰚	rhnt
鰛	rhbq
鰜	rhvm
鰝	rhdo
鰞	rhjh
鰟	rhdh
鰠	rhaq
鰡	rhgq
鰢	rhsh
鰣	rhbd
鰤	rhji
鰥	rhqs
鰦	rhvw
鰧	dvyh
鰨	rhbj
鰩	rhju
鰪	rhlq
鰫	rhno
鰬	rhyx
鰭	rhyb
鰮	rhqq
鰯	rhzv
鰰	rhji
鰱	rhcz
鰲	lhah
鰳	rhhj
鰴	rhea
鰵	lqsh
鰶	rhxm
鰷	rhtm
鰸	rhco
鰹	rhgl
鰺	rhgs
鰻	rhba
鰼	rhjg
鰽	rhub
鰾	rhcm
鰿	rhlv
鱀	egch
鱁	rhxz
鱂	rhkd
鱃	rhvt
鱄	rhtd
鱅	rhji
鱆	rhdx
鱇	rhjs
鱈	rhue
鱉	vnmh
鱊	rhdo
鱋	rhyt
鱌	rhrx
鱍	rhxa
鱎	rhjo
鱏	rhcx
鱐	rhek
鱑	rhhv
鱒	rhvd
鱓	rhox
鱔	rhvo
鱕	rhjq
鱖	rhjv
鱗	rhxi
鱘	rhed
鱙	rhlw
鱚	rhlo
鱛	rhvb
鱜	rhwp
鱝	rhxv
鱞	rhqk
鱟	jkxh
鱠	rhvb
鱡	rhgx
鱢	rhom
鱣	rhdt
鱤	rhju
鱥	rhlx
鱦	rhq
鱧	rhuv
鱨	rhwb
鱩	rhuq
鱪	rhbb
鱫	rhja
鱬	rhun
鱭	rhdh
鱮	rhjv
鱯	rhha
鱰	rhqb
鱱	rhjg
鱲	rhsv
鱳	rhwm
鱴	rhhx
鱵	rhkx
鱶	rhvk
鱷	rheo
鱸	rhyq
鱹	rhhi
鱺	rhtu
鱻	rhrh
鱼	rtby
鱽	rtd
鱾	rtzl
鱿	rtxd
鲀	rttl
鲁	rtb
鲂	rtdh
鲃	rtdl
鲄	rtto
鲅	rtxd
鲆	rtti
鲇	rtyo
鲈	rtyp
鲉	rtd
鲊	rtlk
鲋	rttd
鲌	rtg
鲍	rtse
鲎	wnrt
鲏	rtja
鲐	rtgo
鲑	rtll
鲒	rtlo
鲓	rtys
鲔	rtxd
鲕	rtjn
鲖	rtno
鲗	rtbn
鲘	rtjo
鲙	rtvg
鲚	rtdn
鲛	rtdx
鲜	rtvf
鲝	vfrt
鲞	vyrt
鲟	rted
鲠	rttx
鲡	rttd
鲢	rtcz
鲣	rtnl
鲤	rtbl
鲥	rtbd
鲦	rtam
鲧	rtjm
鲨	smjt
鲩	rtnw
鲪	rteo
鲫	rtep
鲬	rtdi
鲬	rtdf
鲭	rtld
鲮	rtla
鲯	rthv
鲰	rtpa
鲱	rtee
鲲	rtbu
鲳	rtbb
鲴	rtqo
鲵	rtgw
鲶	rtvu
鲷	rtno
鲸	rtdm
鲹	rtgs
鲺	rtzq
鲻	rtsq
鲼	rtxb
鲽	rthm
鲾	rttq
鲿	rtwg
鳀	rtbl
鳁	rtbq
鳂	rtqk
鳃	rtqu
鳄	rtos
鳅	rthx
鳆	rtla
鳇	rtge
鳈	rtgs
鳉	rtkd
鳊	rtdh
鳋	rtaq
鳌	lhat
鳍	rtyb
鳎	rtbj
鳏	rtqv
鳏	rtqs
鳐	rtju
鳑	rtdh
鳒	rtvm
鳓	rthj
鳔	rtcm
鳕	rtue
鳖	vnmt
鳗	rtba
鳘	lqst
鳙	rtji
鳚	rtpd
鳛	rtjg
鳜	rtjv
鳝	rtvo
鳞	rtxi
鳟	rtvd
鳠	rtha
鳡	rtju
鳢	rtuv
鳣	rtdt
鳤	rtkz
鳥	gh
鳦	ghz
鳧	ghw
鳨	ghj
鳩	xgh
鳪	ygh
鳫	jgh
鳬	gw
鳭	dgh
鳮	agh
鳯	wgh
鳰	jdgh
鳱	fgh
鳲	pgh
鳳	wtgh
鳴	ogh
鳵	zxgh
鳶	vgh
鳷	xagh
鳸	dpgh
鳹	vjgh
鳺	fvgh
鳻	vdgh
鳼	dxgh
鳽	thgh
鳾	tnih
鳿	egh
鴀	jygh
鴁	jygh
鴂	zvgh
鴃	ghzv
鴄	cwgh
鴅	ndgh
鴆	plgh
鴇	txgh
鴈	jtgh
鴉	cijh
鴊	tlgh
鴋	dhgh
鴌	tygh
鴍	dxgh
鴎	cxgh
鴏	ghtv
鴐	jogh
鴑	ragh
鴒	vjdh
鴓	ujgh
鴔	jdzh
鴕	ghnt
鴖	ptvh
鴗	dgh
鴘	ghgh
鴙	lygh
鴚	ghto
鴛	dcgh
鴜	ltgh
鴝	sogh
鴞	otsh
鴟	ctvh
鴠	btgh
鴡	qfgh
鴢	wjgh
鴣	xogh
鴤	ghad
鴥	ghnv
鴦	nygh
鴧	nwgh
鴨	qgh
鴩	kvgh
鴪	nvgh
鴫	qgh
鴬	wngh
鴭	jpzh
鴮	yfsh
鴯	jnnh
鴰	jxoh
鴱	hxgh
鴲	tbgh
鴳	nrgh
鴴	sfih
鴵	vwvh
鴶	logh
鴷	tdnh
鴸	kmgh
鴹	vfgh
鴺	tzsh
鴻	sigh
鴼	ghao
鴽	rogh
鴾	gkih
鴿	vtoh
鵀	tjlh
鵁	dvxh
鵂	tmgh
鵃	nsgh
鵄	tglh
鵅	aogh
鵆	sghi
鵇	lcih
鵈	pgh
鵉	dmgh
鵊	yvvh
鵊	tvvh
鵋	zluh
鵌	ghvm
鵍	nfwh
鵎	jrgh
鵏	tdih
鵐	ivvh
鵑	odgh
鵒	vvoh
鵓	xnzh
鵔	ghga
鵕	gvah
鵖	eggh
鵗	xxnh
鵘	ejoh
鵙	gvgh
鵚	hwgh
鵛	tsih
鵜	vzsh
鵝	jfxh
鵞	jfxh
鵟	xjeh
鵠	jloh
鵡	flvh
鵢	rgh
鵣	tomh
鵤	rgh
鵥	vxnh
鵦	ghes
鵧	vhgh
鵨	vfoh
鵩	dpah
鵪	yblh
鵫	ybxh
鵬	ddgh
鵭	vvgh
鵮	rggh
鵯	gjxh
鵰	nloh
鵱	lvlh
鵲	hbgh
鵳	dpdh
鵴	sxgh
鵵	rowh
鵶	txth
鵷	ndch
鵸	ytoh
鵹	hsjh
鵺	dtdh
鵻	ghti
鵼	nvih
鵽	aaah
鵾	bugh
鵿	ghbh
鶀	ghhv
鶁	domh
鶂	gwgh
鶃	ghgw
鶄	ldgh
鶅	sqgh
鶆	xvvh
鶆	tvvh
鶇	tbmh
鶈	teih
鶉	dozh
鶊	jevh
鶋	pxoh
鶌	pueh
鶍	bssh
鶎	nfmh
鶏	jfvh
鶐	mdzh
鶑	xxgh
鶒	tomh
鶓	hqgh
鶔	dtjh
鶕	dbgh
鶖	hxgh
鶗	btlh
鶘	xodh
鶙	dnnh
鶚	oofh
鶛	uggh
鶜	hdth
鶝	toqh
鶞	jjxh
鶟	nvyh
鶠	cbrh
鶡	bsvh
鶢	jfah
鶣	dpnh
鶤	ncgh
鶥	djgh
鶦	xodh
鶧	hnyh
鶨	ljxh
鶩	dtjh
鶪	gydh
鶫	tqmh
鶬	vdeh
鶭	wmdh
鶮	donh
鶯	xxnh
鶰	ogvh
鶱	nfnh
鶲	vgjh
鶳	ghji
鶴	piih
鶵	sujh
鶶	jeih
鶷	nfoh
鶸	zsvh
鶹	gdqh
鶺	xvdh
鶻	qdgh
鶼	vemh
鶽	tixh
鶾	xbxh
鶿	vwwh
鷀	vwwh
鷁	vvqh
鷂	jlxh
鷃	bnrh
鷄	jwyh
鷅	cmgh
鷆	tglh
鷇	lnta
鷈	ghjw
鷉	jjyh
鷊	tonh
鷋	hvth
鷌	ghsh
鷍	jgmh
鷎	gyxh
鷏	xqeh
鷐	bjfh
鷑	kdgh
鷒	tbgh
鷓	jhhh
鷔	lhah
鷕	otih
鷖	clyh
鷗	cooh
鷘	tomh
鷙	lyxh
鷙	lvxh
鷚	jjvh
鷛	jedh
鷜	otoh
鷝	bhfh
鷞	yxxh
鷟	dhlh
鷠	rhgh
鷡	lhhh
鷢	jvuh
鷣	cbxh
鷤	oobh
鷥	wmwh
鷦	tihh
鷧	lnth
鷨	hthh
鷩	vnmh
鷪	ggnh
鷫	eikh
鷬	hdvh
鷭	jxqh
鷮	jyoh
鷯	yvbh
鷰	hokh
鷰	hkoh
鷱	jgxh
鷲	domh
鷳	ndgh
鷴	nmgh
鷵	pybh
鷶	qgvh
鷷	vuxh
鷸	dtjh
鷹	jtth
鷺	olah
鷻	ghda
鷼	nbgh
鷽	jkxh
鷾	dbuh
鷿	podh
鸀	qsqh
鸁	dloh
鸁	dlod
鸂	sjwh
鸃	ghvx
鸄	gdhh
鸅	qlyh
鸅	qlvh
鸆	yoth
鸇	dqoh
鸈	wtvh
鸉	mbth
鸉	mbjh
鸊	podh
鸋	nuqh
鸌	ghha
鸍	tvnh
鸎	gvgh
鸏	hnfh
鸐	jjth
鸑	xjih
鸒	jksh
鸓	qqqh
鸔	ghbs
鸕	yqqh
鸖	utih
鸗	ddth
鸗	ddsh
鸘	umgh
鸙	vtoh
鸚	gvgh
鸛	hooh
鸜	ggth
鸝	tndh
鸞	wmih
鸟	gtcn
鸟	gtan
鸠	xgt
鸡	agt
鸢	vgt
鸣	ogt
鸤	pgt
鸥	cxgt
鸦	cijt
鸧	vcgt
鸨	txgt
鸩	plgt
鸪	xogt
鸫	tmgt
鸬	ypgt
鸭	qgt
鸮	otst
鸯	nygt
鸰	vjdt
鸱	ctvt
鸲	sogt
鸳	dcgt
鸴	wngt
鸵	gtnt
鸶	wwtt
鸷	fxdt
鸸	jnnt
鸹	jxot
鸺	tmgt
鸻	sfit
鸼	nsgt
鸽	vtot
鸾	dmgt
鸿	sigt
鹀	ivvt
鹁	xnzt
鹂	tndt
鹃	odgt
鹄	jlot
鹅	jfxt
鹆	vvot
鹇	nmgt
鹈	vzst
鹉	flvt
鹊	hbgt
鹋	hqgt
鹌	yblt
鹍	bugt
鹎	gjxt
鹏	ddht
鹐	rggt
鹑	dozt
鹒	jevt
鹓	ndct
鹔	emnt
鹔	eijt
鹕	xodt
鹖	bsvt
鹗	ooft
鹘	qdgt
鹙	hxgt
鹚	vwwt
鹛	djgt
鹜	dtjt
鹝	tont
鹞	jlxt
鹟	vgjt
鹠	gdqt
鹡	xvdt
鹢	vvqt
鹣	vemt
鹤	piit
鹥	clyt
鹦	bbrt
鹧	jhht
鹨	jjvt
鹩	yvbt
鹪	tiht
鹫	domt
鹬	dtjt
鹭	olat
鹮	qtot
鹯	dqot
鹰	jttt
鹱	gtha
鹲	hnft
鹳	hoot
鹴	umgt
鹵	yqdx
鹵	yqdd
鹶	yqdj
鹷	yqdd
鹸	yqdv
鹹	yqdx
鹺	yqdi
鹻	yqdm
鹼	yqdv
鹽	glyq
鹾	yqxi
鹿	jznu
麀	jznt
麁	rjzu
麂	jznw
麃	jznh
麄	vdju
麅	jzne
麆	jznf
麇	jznh
麈	jzne
麉	ffju
麊	xjzu
麋	jznx
麌	jzny
麍	jznm
麎	jznk
麏	jzno
麐	jzno
麑	jznw
麒	jznv
麓	mmju
麔	jzno
麕	jznh
麖	jznm
麗	tndu
麘	jznb
麙	jznx
麚	jzna
麛	jznp
麜	jznm
麝	jznd
麞	jznx
麟	jzni
麠	jznt
麡	jznh
麢	jzno
麣	jzna
麤	jznu
麥	xvva
麥	tvva
麦	labm
麧	xvvz
麧	tvvz
麨	xvvj
麨	tvvj
麩	xvvv
麩	tvvv
麪	xvvj
麪	tvvj
麫	xvvs
麫	tvvs
麬	xvva
麬	tvva
麭	xvve
麭	tvve
麮	xvvg
麮	tvvg
麯	xvvu
麯	tvvu
麰	xvvi
麰	tvvi
麱	xvvd
麱	tvvd
麲	xvvw
麲	tvvw
麳	xvvv
麳	xvvm
麳	tvvv
麳	tvvm
麴	xvvx
麴	tvvx
麵	xvvf
麵	tvvf
麶	xvvg
麶	tvvg
麷	xvvv
麷	tvvv
麸	lafv
麹	lasx
麺	lajf
麻	jmm
麼	jmmw
麽	jmmg
麾	jmml
麿	jmmo
黀	jmma
黁	jmmb
黂	jmmv
黃	htdv
黄	hdv
黅	hdvj
黆	hdvl
黇	hdvo
黈	hdve
黉	wnhv
黊	hdvl
黋	wwhv
黌	jkxv
黍	hvs
黎	hsjs
黏	hvso
黐	hvsg
黑	qhbh
黒	blh
黓	qhv
黔	qhvj
黕	qhpl
黖	qhcw
黗	qhtl
默	qhyd
黙	blyh
黚	qhhf
黛	tvqh
黜	qhue
黝	qhwj
點	qhyo
黟	qhdd
黠	qhlo
黡	jydh
黢	qhga
黣	qhls
黤	qhyl
黥	qhdm
黦	qhnc
黧	hsjh
黨	wnoh
黩	qhxy
黪	qhgs
黫	qhcl
黬	qhjx
黭	qhvh
黮	qhhl
黯	qhdb
黰	qhxv
黱	dvyh
黲	qhgs
黳	clyh
黴	seta
黵	qhri
黶	jbdh
黷	qhlv
黸	qhyq
黹	wtvm
黺	wtvd
黻	wtvd
黼	wtvd
黽	qii
黾	obl
黿	fwq
鼀	lvq
鼁	lgq
鼂	btq
鼃	llq
鼄	kmq
鼅	lyoq
鼆	nbdq
鼇	lhaq
鼈	vnmq
鼉	ooqq
鼊	podq
鼋	fwol
鼌	btol
鼍	ooql
鼎	gkk
鼏	ngkk
鼐	zjgk
鼑	ygkk
鼒	xjgk
鼓	lova
鼔	lova
鼕	lovd
鼖	xhla
鼗	vwva
鼘	lovk
鼙	lovx
鼚	lovk
鼛	lovo
鼜	lovq
鼝	skta
鼞	lovl
鼟	lovv
鼠	gldv
鼡	wwf
鼢	gldd
鼣	gldd
鼤	gldx
鼥	gldd
鼦	gldo
鼧	gldt
鼨	gldd
鼩	gldo
鼪	gldl
鼫	gldc
鼬	gldd
鼭	gldd
鼮	gldz
鼯	gldo
鼰	gldv
鼱	gldd
鼲	gldc
鼳	gldd
鼴	gldr
鼵	gldd
鼶	gldw
鼷	gldy
鼸	gldm
鼹	gldr
鼺	gldq
鼻	jgqn
鼼	jgqi
鼽	jgqx
鼾	jgqf
鼿	jgqw
齀	jgqd
齁	jgqo
齂	jgqs
齃	jgql
齄	jgqt
齅	jgqd
齆	jgql
齇	jgqf
齈	jgqk
齉	jgqk
齊	ddyh
齋	ddym
齌	ddyx
齍	ddyq
齎	ddyv
齏	ddyt
齐	dxnq
齐	dxnc
齑	dxji
齒	lvvu
齓	lvvl
齔	lvvt
齕	lvvz
齖	lvvj
齗	lvvt
齘	lvvn
齙	lvve
齚	lvvk
齛	lvvl
齜	lvvt
齝	lvvo
齞	lvvv
齟	lvvf
齠	lvvo
齡	lvvd
齢	lxud
齣	lvvo
齤	vylu
齥	lvvx
齦	lvvk
齧	fdlu
齨	lvvg
齩	lvvx
齪	lvvl
齫	lvvm
齬	lvvo
齭	lvvt
齮	lvvo
齯	lvvw
齰	lvvb
齱	lvva
齲	lvvg
齳	lvvc
齴	lvvs
齵	lvvg
齶	lvvs
齷	lvvl
齸	lvvq
齹	vfiu
齺	lvvj
齻	lvvv
齼	lvvl
齽	lvvm
齾	ytou
齿	lwbc
齿	lvu
龀	lwt
龀	lvut
龁	lwlz
龁	lvuz
龂	lwjt
龂	lvut
龃	lwqf
龃	lvuf
龄	lwvd
龄	lvud
龅	lwse
龅	lvue
龆	lwdo
龆	lvuo
龇	lwlt
龇	lvut
龈	lwek
龈	lvuk
龉	lwwo
龉	lvuo
龊	lwol
龊	lvul
龋	lwjg
龋	lvug
龌	lwpl
龌	lvul
龍	ddte
龍	ddse
龎	jdde
龏	ddth
龏	ddsh
龐	jdde
龑	ddty
龑	ddsy
龒	ddtm
龒	ddsm
龓	xdde
龔	ddtv
龔	ddsv
龕	vtoe
龖	ddte
龖	ddse
龗	uooe
龘	ddte
龘	ddse
龙	xtd
龚	xtdv
龛	vtod
龜	jq
龜	jlzx
龜	jlzl
龝	hjq
龝	hjlx
龝	hjll
龞	vnmx
龞	vnmq
龞	vnml
龟	rblg
龠	vtoh
龡	vtov
龢	vtoh
龣	vtos
龤	vtog
龥	vtov
	jj
	xii
	lii
	jii
	zii
	tsuj
	tre
	rii
	cii
	dii
	oonv
	onja
	onja
	wii
	md
	ysuj
	yre
	jf
	fnx
	fsc
	ftia
	faa
	lii
	hii
	mnx
	tdqb
	syz
	jl
	ev
	wn
	jl
	gxr
	hgys
	kii
	wd
	nw
	vf
	ve
	lx
	emqt
	emqg
	el
	eit
	dfsd
	hnvj
	jkqv
	jkqb
	vy
	ijjt
	ihoh
	ihkh
	gvld
	bld
	ol
	vvdj
	vcij
	vyad
	vdpj
	vhyb
	vvfo
	vgga
	nnvl
	nnri
	nvvl
	nrei
	xbx
	xxn
	yrta
	rtep
	rteb
	rtvu
	yrha
	dvyt
	tnit
	dvxt
	tdnt
	ldgt
	gydt
	jjyt
	podt
	xtdy
	wmim
郎	dekp
﨎	dxta
﨏	lvvo
﨑	edto
﨓	mhtd
﨔	mwvf
礼	fml
﨟	hdbl
蘒	hhjx
﨡	qjl
﨣	lldx
﨤	jznz
﨧	vvyz
﨨	vvly
﨨	vvlx
